image_id,difficulty,TP,FP,FN,FN_Details
Image__2023-12-11__12-33-23_label8_cls0,133,0,133,0,{}
Image__2023-12-11__12-33-23_label9_cls0,126,0,126,0,{}
Image__2023-03-01__14-02-16_label0_cls0,126,0,126,0,{}
Image__2023-02-07__14-46-21_label2_cls0,117,0,116,1,{'dirt': 1}
Image__2023-03-15__14-24-10_label0_cls0,112,0,111,1,{'dirt': 1}
Image__2023-12-11__12-33-23_label4_cls0,104,0,104,0,{}
Image__2023-03-06__13-21-57_label0_cls0,99,0,99,0,{}
Image__2023-12-11__12-33-23_label5_cls0,97,0,97,0,{}
Image__2023-12-11__12-33-23_label3_cls0,96,0,96,0,{}
Image__2023-12-11__12-33-23_label11_cls0,94,0,94,0,{}
Image__2023-05-24__12-53-46_label0_cls0,94,0,87,7,{'dirt': 7}
Image__2023-02-27__14-28-09_label0_cls0,92,0,91,1,{'dirt': 1}
Image__2024-04-17__12-22-30_label0_cls0,91,0,91,0,{}
Image__2023-12-11__12-33-23_label2_cls0,91,0,91,0,{}
Image__2023-05-24__12-53-46_label1_cls0,91,0,83,8,{'dirt': 8}
Image__2023-05-24__12-53-46_label3_cls0,89,0,81,8,{'dirt': 8}
Image__2023-02-07__14-46-21_label1_cls0,88,0,87,1,{'dirt': 1}
Image__2023-03-17__12-47-35_label0_cls0,86,0,85,1,{'dirt': 1}
Image__2023-12-11__12-33-23_label6_cls0,85,0,85,0,{}
Image__2023-03-14__14-05-27_label0_cls0,85,0,83,2,{'dirt': 2}
Image__2023-02-23__14-15-34_label0_cls0,84,0,83,1,{'dirt': 1}
Image__2023-12-11__12-32-34_label2_cls0,81,0,81,0,{}
Image__2023-05-24__12-27-38_label0_cls0,81,0,80,1,{'dirt': 1}
Image__2023-05-24__12-53-46_label4_cls0,81,0,72,9,{'dirt': 9}
Image__2023-05-24__12-53-46_label2_cls0,80,0,71,9,{'dirt': 9}
Image__2023-03-02__13-30-47_label0_cls0,80,0,80,0,{}
Image__2024-01-27__12-36-01_label0_cls0,79,0,79,0,{}
Image__2023-03-14__13-32-08_label0_cls0,78,0,77,1,{'dirt': 1}
Image__2023-03-01__14-03-40_label0_cls0,78,0,78,0,{}
Image__2023-12-11__12-33-23_label1_cls0,78,0,78,0,{}
Image__2023-02-22__13-51-10_label0_cls0,76,0,74,2,{'dirt': 2}
Image__2023-05-24__12-53-46_label6_cls0,76,0,70,6,{'dirt': 6}
Image__2023-03-01__13-57-22_label0_cls0,76,0,76,0,{}
Image__2023-03-17__13-07-27_label0_cls0,76,0,74,2,{'dirt': 2}
Image__2023-03-10__13-47-28_label0_cls0,76,0,75,1,{'dirt': 1}
Image__2023-05-24__12-37-02_label0_cls0,76,0,75,1,{'dirt': 1}
Image__2024-04-10__12-17-06_label0_cls0,76,0,76,0,{}
Image__2023-02-27__13-51-41_label0_cls0,75,0,74,1,{'dirt': 1}
Image__2023-05-24__12-53-46_label9_cls0,75,0,68,7,{'dirt': 7}
Image__2024-01-18__13-18-00_label0_cls0,74,0,74,0,{}
Image__2023-03-15__14-15-39_label0_cls0,74,0,73,1,{'dirt': 1}
Image__2023-03-09__14-57-51_label0_cls0,73,0,71,2,{'dirt': 2}
Image__2023-02-27__13-47-36_label0_cls0,72,0,71,1,{'dirt': 1}
Image__2023-02-22__13-28-32_label1_cls0,71,0,70,1,{'dirt': 1}
Image__2023-05-24__12-53-46_label5_cls0,70,0,62,8,{'dirt': 8}
Image__2023-12-11__12-33-23_label10_cls0,70,0,70,0,{}
Image__2023-05-24__12-53-46_label8_cls0,70,0,63,7,{'dirt': 7}
Image__2024-05-17__12-23-19_label0_cls0,70,0,70,0,{}
Image__2023-03-08__10-43-57_label0_cls0,69,0,67,2,{'dirt': 2}
Image__2023-03-08__10-38-27_label1_cls0,69,0,67,2,{'dirt': 2}
Image__2023-03-06__14-12-03_label0_cls0,68,0,68,0,{}
Image__2023-02-22__13-28-32_label0_cls0,68,0,67,1,{'dirt': 1}
Image__2023-05-24__12-53-46_label7_cls0,68,0,61,7,{'dirt': 7}
Image__2023-03-01__13-21-58_label0_cls0,68,0,68,0,{}
Image__2023-02-28__14-19-21_label0_cls0,67,0,67,0,{}
Image__2023-12-11__12-32-34_label0_cls0,67,0,67,0,{}
Image__2023-02-22__14-01-07_label0_cls0,67,0,65,2,{'dirt': 2}
Image__2023-03-15__14-24-49_label0_cls0,67,0,65,2,{'dirt': 2}
Image__2023-03-01__13-35-57_label0_cls0,67,0,67,0,{}
Image__2023-10-30__13-20-23_label0_cls0,67,0,65,2,{'dirt': 2}
Image__2023-03-01__13-16-05_label0_cls0,66,0,66,0,{}
Image__2024-05-21__12-19-09_label0_cls0,66,0,66,0,{}
Image__2023-03-17__13-07-27_label1_cls0,66,0,64,2,{'dirt': 2}
Image__2024-04-11__12-26-03_label0_cls0,66,0,66,0,{}
Image__2023-12-11__12-33-23_label7_cls0,65,0,65,0,{}
Image__2023-02-22__13-30-24_label0_cls0,64,0,63,1,{'dirt': 1}
Image__2023-03-10__13-41-10_label0_cls0,64,0,62,2,{'dirt': 2}
Image__2023-12-11__12-32-34_label1_cls0,64,0,64,0,{}
Image__2024-03-23__12-30-29_label0_cls0,64,0,64,0,{}
Image__2023-03-13__13-09-38_label0_cls0,63,0,62,1,{'dirt': 1}
Image__2023-03-14__14-05-27_label1_cls0,63,0,61,2,{'dirt': 2}
Image__2023-03-13__12-58-07_label0_cls0,63,0,58,5,{'dirt': 5}
Image__2023-02-22__13-44-17_label0_cls0,63,0,61,2,{'dirt': 2}
Image__2023-03-17__12-54-30_label0_cls0,61,0,59,2,{'dirt': 2}
Image__2023-03-02__13-58-00_label0_cls0,60,0,60,0,{}
Image__2023-03-13__12-40-24_label1_cls0,60,0,59,1,{'dirt': 1}
Image__2023-02-27__14-21-27_label0_cls0,59,0,58,1,{'dirt': 1}
Image__2023-02-27__14-24-05_label0_cls0,59,0,58,1,{'dirt': 1}
Image__2023-05-24__12-28-40_label1_cls0,58,0,56,2,{'dirt': 2}
Image__2024-04-06__12-36-36_label0_cls0,58,0,58,0,{}
Image__2023-02-23__14-25-09_label0_cls0,57,0,56,1,{'dirt': 1}
Image__2023-03-08__10-43-57_label2_cls0,57,0,57,0,{}
Image__2023-03-08__10-43-57_label1_cls0,57,0,57,0,{}
Image__2023-02-27__13-48-20_label1_cls0,56,0,55,1,{'dirt': 1}
Image__2023-03-08__10-38-27_label0_cls0,56,0,54,2,{'dirt': 2}
Image__2023-03-13__13-22-19_label0_cls0,56,0,54,2,{'dirt': 2}
Image__2023-03-01__13-58-25_label1_cls0,56,0,56,0,{}
Image__2023-03-02__14-34-12_label0_cls0,56,0,56,0,{}
Image__2023-12-11__12-38-00_label0_cls0,55,0,55,0,{}
Image__2023-03-13__12-54-31_label0_cls0,55,0,54,1,{'dirt': 1}
Image__2023-03-06__14-11-36_label0_cls0,55,0,55,0,{}
Image__2023-12-11__12-30-03_label0_cls0,55,0,55,0,{}
Image__2023-03-02__14-23-09_label0_cls0,54,0,54,0,{}
Image__2023-03-01__13-16-05_label1_cls0,54,0,54,0,{}
Image__2023-12-26__12-53-33_label0_cls0,54,0,54,0,{}
Image__2023-12-08__13-01-48_label1_cls0,54,0,54,0,{}
Image__2023-02-24__10-45-00_label0_cls0,54,0,53,1,{'dirt': 1}
Image__2023-12-11__12-33-23_label0_cls0,54,0,54,0,{}
Image__2023-03-08__10-12-33_label0_cls0,54,0,54,0,{}
Image__2023-02-01__15-26-10_label0_cls0,54,0,52,2,{'dirt': 2}
Image__2023-02-22__13-34-53_label0_cls0,54,0,53,1,{'dirt': 1}
Image__2023-03-13__13-07-01_label0_cls0,54,0,53,1,{'dirt': 1}
Image__2024-01-09__13-14-29_label0_cls0,53,0,53,0,{}
Image__2024-03-19__12-27-28_label0_cls0,53,0,53,0,{}
Image__2023-02-22__13-51-50_label0_cls0,53,0,52,1,{'dirt': 1}
Image__2024-03-02__13-14-46_label0_cls0,53,0,53,0,{}
Image__2023-05-24__12-49-56_label0_cls0,53,0,48,5,{'dirt': 5}
Image__2024-05-21__12-21-01_label0_cls0,53,0,53,0,{}
Image__2023-02-24__10-27-39_label0_cls0,53,0,52,1,{'dirt': 1}
Image__2024-05-17__12-15-56_label0_cls0,53,0,53,0,{}
Image__2023-03-14__14-21-12_label0_cls0,53,0,52,1,{'dirt': 1}
Image__2023-05-24__12-45-26_label0_cls0,52,0,51,1,{'dirt': 1}
Image__2023-03-10__13-58-52_label1_cls0,52,0,50,2,{'dirt': 2}
Image__2023-03-15__13-38-25_label0_cls0,52,0,51,1,{'dirt': 1}
Image__2023-03-09__14-41-05_label0_cls0,52,0,51,1,{'dirt': 1}
Image__2024-05-17__12-27-33_label0_cls0,51,0,51,0,{}
Image__2023-02-24__10-35-03_label1_cls0,51,0,49,2,{'dirt': 2}
Image__2024-03-16__13-42-03_label0_cls0,51,0,51,0,{}
Image__2024-03-16__13-45-34_label0_cls0,51,0,51,0,{}
Image__2024-03-02__13-16-56_label0_cls0,51,0,51,0,{}
Image__2024-02-21__12-34-04_label0_cls0,51,0,51,0,{}
Image__2023-02-28__13-52-10_label0_cls0,50,0,49,1,{'dirt': 1}
Image__2024-04-16__12-23-26_label0_cls0,50,0,50,0,{}
Image__2023-03-08__10-32-03_label3_cls0,50,0,50,0,{}
Image__2023-02-23__14-20-56_label2_cls0,50,0,48,2,{'dirt': 2}
Image__2023-03-01__13-58-25_label0_cls0,50,0,50,0,{}
Image__2023-03-01__14-11-01_label0_cls0,49,0,49,0,{}
Image__2023-03-01__14-01-55_label0_cls0,49,0,49,0,{}
Image__2024-01-18__13-12-42_label0_cls0,49,0,49,0,{}
Image__2023-03-02__14-33-38_label4_cls0,48,0,48,0,{}
Image__2023-02-24__10-27-09_label0_cls0,48,0,47,1,{'dirt': 1}
Image__2023-03-10__13-16-19_label0_cls0,48,0,48,0,{}
Image__2023-02-24__10-25-21_label0_cls0,48,0,47,1,{'dirt': 1}
Image__2023-02-27__14-35-10_label1_cls0,48,0,47,1,{'dirt': 1}
Image__2023-03-01__13-46-05_label3_cls0,48,0,48,0,{}
Image__2023-03-01__14-02-35_label0_cls0,48,0,48,0,{}
Image__2024-02-21__12-37-34_label0_cls0,48,0,48,0,{}
Image__2023-02-27__13-48-42_label0_cls0,47,0,46,1,{'dirt': 1}
Image__2023-03-02__14-27-06_label0_cls0,47,0,47,0,{}
Image__2023-03-10__13-38-27_label0_cls0,47,0,46,1,{'dirt': 1}
Image__2023-03-13__13-32-50_label0_cls0,47,0,46,1,{'dirt': 1}
Image__2023-03-01__13-37-08_label0_cls0,47,0,47,0,{}
Image__2023-03-15__13-30-17_label4_cls0,47,0,39,8,{'dirt': 8}
Image__2023-02-27__13-48-20_label0_cls0,47,0,46,1,{'dirt': 1}
Image__2023-03-13__13-11-17_label0_cls0,47,0,46,1,{'dirt': 1}
Image__2023-02-22__13-40-04_label0_cls0,46,0,45,1,{'dirt': 1}
Image__2023-03-01__13-16-32_label1_cls0,46,0,46,0,{}
Image__2023-02-22__13-51-10_label1_cls0,46,0,45,1,{'dirt': 1}
Image__2023-03-15__13-30-17_label6_cls0,46,0,38,8,{'dirt': 8}
Image__2023-03-13__12-49-13_label4_cls0,46,0,42,4,{'dirt': 4}
Image__2023-03-06__13-27-55_label0_cls0,46,0,46,0,{}
Image__2024-04-06__12-31-14_label0_cls0,46,0,46,0,{}
Image__2023-03-08__10-07-54_label0_cls0,46,0,45,1,{'dirt': 1}
Image__2023-03-13__12-49-13_label1_cls0,45,0,41,4,{'dirt': 4}
Image__2023-12-11__12-34-47_label5_cls0,45,0,45,0,{}
Image__2023-02-23__14-10-04_label2_cls0,45,0,43,2,{'dirt': 2}
Image__2023-03-15__13-30-17_label5_cls0,45,0,37,8,{'dirt': 8}
Image__2024-04-16__12-16-23_label0_cls0,45,0,45,0,{}
Image__2023-02-28__14-27-03_label0_cls0,45,0,44,1,{'dirt': 1}
Image__2023-02-27__14-36-54_label0_cls0,45,0,44,1,{'dirt': 1}
Image__2024-01-27__12-37-25_label0_cls0,45,0,45,0,{}
Image__2023-03-08__10-26-40_label1_cls0,44,0,44,0,{}
Image__2023-05-24__12-44-32_label0_cls0,44,0,40,4,{'dirt': 4}
Image__2023-03-13__12-50-11_label0_cls0,44,0,43,1,{'dirt': 1}
Image__2023-12-16__13-39-35_label0_cls0,44,0,44,0,{}
Image__2023-02-24__10-41-53_label0_cls0,44,0,43,1,{'dirt': 1}
Image__2024-01-18__13-16-53_label0_cls0,44,0,44,0,{}
Image__2023-03-15__13-50-58_label0_cls0,44,0,43,1,{'dirt': 1}
Image__2023-02-23__14-17-10_label0_cls0,44,0,43,1,{'dirt': 1}
Image__2024-04-25__13-17-11_label0_cls0,43,0,43,0,{}
Image__2023-03-01__13-34-55_label0_cls0,43,0,43,0,{}
Image__2023-03-13__12-58-07_label1_cls0,43,0,38,5,{'dirt': 5}
Image__2023-02-22__14-05-49_label3_cls0,43,0,42,1,{'dirt': 1}
Image__2023-05-24__12-28-40_label0_cls0,43,0,41,2,{'dirt': 2}
Image__2023-03-02__14-29-38_label0_cls0,42,0,42,0,{}
Image__2023-03-15__13-30-17_label8_cls0,42,0,34,8,{'dirt': 8}
Image__2023-03-14__14-17-22_label0_cls0,42,0,40,2,{'dirt': 2}
Image__2023-03-13__12-57-21_label0_cls0,42,0,41,1,{'dirt': 1}
Image__2023-02-24__10-34-41_label0_cls0,42,0,41,1,{'dirt': 1}
Image__2023-02-23__14-20-56_label0_cls0,42,0,40,2,{'dirt': 2}
Image__2024-04-03__13-32-03_label0_cls0,42,0,42,0,{}
Image__2023-02-27__13-55-11_label1_cls0,42,0,41,1,{'dirt': 1}
Image__2024-04-10__12-22-07_label0_cls0,42,0,42,0,{}
Image__2023-02-07__14-46-21_label0_cls0,42,0,41,1,{'dirt': 1}
Image__2023-02-27__13-53-25_label0_cls0,42,0,41,1,{'dirt': 1}
Image__2023-02-07__14-39-37_label0_cls0,42,0,41,1,{'dirt': 1}
Image__2023-05-24__12-56-03_label0_cls0,42,0,41,1,{'dirt': 1}
Image__2023-03-08__10-14-48_label0_cls0,42,0,42,0,{}
Image__2023-12-11__12-34-47_label4_cls0,42,0,42,0,{}
Image__2024-01-30__13-10-10_label0_cls0,42,0,42,0,{}
Image__2023-03-13__13-36-35_label0_cls0,41,0,40,1,{'dirt': 1}
Image__2023-03-06__14-11-36_label1_cls0,41,0,41,0,{}
Image__2023-12-08__13-01-48_label0_cls0,41,0,41,0,{}
Image__2023-02-27__14-09-17_label0_cls0,41,0,40,1,{'dirt': 1}
Image__2023-02-22__13-30-49_label0_cls0,41,0,39,2,{'dirt': 2}
Image__2024-03-02__13-16-24_label0_cls0,41,0,41,0,{}
Image__2023-02-27__14-06-15_label0_cls0,41,0,40,1,{'dirt': 1}
Image__2023-02-28__14-29-59_label0_cls0,41,0,39,2,{'dirt': 2}
Image__2023-02-23__14-33-16_label3_cls0,41,0,38,3,{'dirt': 3}
Image__2023-03-01__13-47-44_label2_cls0,40,0,40,0,{}
Image__2023-03-13__12-40-24_label0_cls0,40,0,39,1,{'dirt': 1}
Image__2023-03-15__13-30-17_label0_cls0,40,0,32,8,{'dirt': 8}
Image__2023-02-27__13-58-53_label2_cls0,40,0,39,1,{'dirt': 1}
Image__2023-03-17__13-22-09_label0_cls0,40,0,39,1,{'dirt': 1}
Image__2023-03-02__13-56-16_label0_cls0,40,0,40,0,{}
Image__2023-02-22__14-05-49_label1_cls0,40,0,39,1,{'dirt': 1}
Image__2023-03-17__13-19-50_label0_cls0,40,0,39,1,{'dirt': 1}
Image__2023-03-10__13-58-52_label0_cls0,40,0,38,2,{'dirt': 2}
Image__2023-02-24__10-35-03_label0_cls0,40,0,38,2,{'dirt': 2}
Image__2023-02-24__10-45-00_label1_cls0,40,0,39,1,{'dirt': 1}
Image__2023-03-08__10-38-56_label0_cls0,39,0,38,1,{'dirt': 1}
Image__2023-02-23__14-32-49_label0_cls0,39,0,38,1,{'dirt': 1}
Image__2024-04-15__12-13-33_label0_cls0,39,0,39,0,{}
Image__2023-03-13__12-49-13_label0_cls0,39,0,35,4,{'dirt': 4}
Image__2023-02-27__14-11-17_label1_cls0,39,0,38,1,{'dirt': 1}
Image__2023-02-27__14-07-24_label0_cls0,39,0,38,1,{'dirt': 1}
Image__2023-02-27__13-58-53_label1_cls0,39,0,38,1,{'dirt': 1}
Image__2023-03-08__10-32-03_label2_cls0,39,0,39,0,{}
Image__2023-03-01__13-46-05_label2_cls0,39,0,39,0,{}
Image__2023-03-10__13-44-13_label0_cls0,39,0,38,1,{'dirt': 1}
Image__2023-03-01__13-19-10_label0_cls0,39,0,39,0,{}
Image__2023-02-24__10-36-23_label0_cls0,39,0,38,1,{'dirt': 1}
Image__2023-05-24__12-44-32_label1_cls0,39,0,35,4,{'dirt': 4}
Image__2023-03-06__13-43-11_label0_cls0,38,0,38,0,{}
Image__2023-03-10__13-42-49_label1_cls0,38,0,26,12,{'dirt': 12}
Image__2023-02-28__14-22-48_label0_cls0,38,0,38,0,{}
Image__2023-02-24__10-27-09_label1_cls0,38,0,37,1,{'dirt': 1}
Image__2024-01-30__13-09-16_label1_cls0,38,0,38,0,{}
Image__2023-03-02__13-36-32_label1_cls0,38,0,38,0,{}
Image__2024-05-18__13-14-34_label0_cls0,38,0,38,0,{}
Image__2023-03-15__13-30-17_label7_cls0,38,0,31,7,{'dirt': 7}
Image__2023-02-06__15-19-35_label0_cls0,38,0,36,2,{'dirt': 2}
Image__2023-02-28__14-08-44_label0_cls0,38,0,38,0,{}
Image__2023-03-01__13-29-36_label0_cls0,38,0,38,0,{}
Image__2023-02-06__15-21-46_label0_cls0,38,0,37,1,{'dirt': 1}
Image__2024-05-16__12-30-08_label0_cls0,38,0,38,0,{}
Image__2023-03-06__13-40-07_label2_cls0,38,0,38,0,{}
Image__2023-02-27__13-58-53_label3_cls0,37,0,36,1,{'dirt': 1}
Image__2023-03-10__13-02-16_label0_cls0,37,0,37,0,{}
Image__2023-05-24__12-34-21_label0_cls0,37,0,35,2,{'dirt': 2}
Image__2023-02-27__13-52-35_label1_cls0,37,0,36,1,{'dirt': 1}
Image__2023-03-13__12-55-56_label0_cls0,37,0,36,1,{'dirt': 1}
Image__2024-03-19__12-33-09_label0_cls0,37,0,37,0,{}
Image__2023-02-27__14-37-25_label0_cls0,37,0,36,1,{'dirt': 1}
Image__2024-03-19__12-23-38_label0_cls0,37,0,37,0,{}
Image__2023-03-14__14-16-52_label0_cls0,37,0,36,1,{'dirt': 1}
Image__2023-03-15__13-56-24_label1_cls0,37,0,35,2,{'dirt': 2}
Image__2023-03-10__13-05-12_label0_cls0,37,0,37,0,{}
Image__2023-03-01__14-07-09 - コピー_label0_cls0,37,0,37,0,{}
Image__2024-04-06__12-34-35_label0_cls0,37,0,37,0,{}
Image__2023-03-15__14-08-18_label0_cls0,37,0,36,1,{'dirt': 1}
Image__2023-03-06__13-32-03_label0_cls0,36,0,36,0,{}
Image__2023-03-08__10-34-00_label0_cls0,36,0,36,0,{}
Image__2023-03-15__13-30-17_label3_cls0,36,0,28,8,{'dirt': 8}
Image__2024-03-23__12-37-24_label0_cls0,36,0,36,0,{}
Image__2023-03-14__14-20-10_label0_cls0,36,0,34,2,{'dirt': 2}
Image__2023-02-24__10-42-27_label0_cls0,36,0,35,1,{'dirt': 1}
Image__2023-02-27__14-13-12_label0_cls0,36,0,35,1,{'dirt': 1}
Image__2023-02-22__13-53-24_label0_cls0,36,0,35,1,{'dirt': 1}
Image__2023-03-17__12-57-29_label0_cls0,36,0,35,1,{'dirt': 1}
Image__2023-03-15__14-06-49_label5_cls0,36,0,30,6,{'dirt': 6}
Image__2023-03-08__10-26-09_label0_cls0,36,0,36,0,{}
Image__2023-02-22__14-08-31_label1_cls0,36,0,35,1,{'dirt': 1}
Image__2024-05-23__12-10-12_label0_cls0,36,0,36,0,{}
Image__2023-03-06__14-11-18_label0_cls0,36,0,36,0,{}
Image__2023-03-09__14-56-21_label0_cls0,36,0,35,1,{'dirt': 1}
Image__2023-03-06__14-02-02_label0_cls0,36,0,36,0,{}
Image__2023-03-06__13-45-01_label0_cls0,36,0,36,0,{}
Image__2023-12-16__13-36-33_label0_cls0,36,0,36,0,{}
Image__2023-02-27__14-11-17_label0_cls0,36,0,35,1,{'dirt': 1}
Image__2024-05-16__12-19-16_label0_cls0,35,0,35,0,{}
Image__2023-03-01__13-14-52_label0_cls0,35,0,35,0,{}
Image__2023-02-23__14-20-30_label0_cls0,35,0,34,1,{'dirt': 1}
Image__2023-03-15__14-24-49_label1_cls0,35,0,30,5,{'dirt': 5}
Image__2024-03-23__12-24-03_label0_cls0,35,0,35,0,{}
Image__2023-03-13__12-53-56_label0_cls0,35,0,34,1,{'dirt': 1}
Image__2023-02-27__13-58-53_label5_cls0,35,0,34,1,{'dirt': 1}
Image__2023-02-27__13-57-45_label0_cls0,35,0,34,1,{'dirt': 1}
Image__2023-02-23__14-20-56_label1_cls0,35,0,33,2,{'dirt': 2}
Image__2023-02-27__13-58-16_label0_cls0,35,0,34,1,{'dirt': 1}
Image__2023-02-27__14-37-51_label0_cls0,35,0,34,1,{'dirt': 1}
Image__2024-05-21__12-16-46_label0_cls0,35,0,35,0,{}
Image__2023-03-10__13-53-13_label0_cls0,35,0,34,1,{'dirt': 1}
Image__2024-01-09__13-13-59_label0_cls0,35,0,35,0,{}
Image__2024-04-16__12-14-48_label0_cls0,35,0,35,0,{}
Image__2023-02-22__14-05-49_label0_cls0,35,0,34,1,{'dirt': 1}
Image__2023-03-01__13-23-33_label0_cls0,35,0,35,0,{}
Image__2023-12-11__12-34-47_label1_cls0,35,0,35,0,{}
Image__2023-03-14__14-17-22_label2_cls0,35,0,34,1,{'dirt': 1}
Image__2023-03-13__12-49-13_label3_cls0,35,0,31,4,{'dirt': 4}
Image__2024-01-23__13-05-31_label0_cls0,34,0,34,0,{}
Image__2023-03-15__13-56-58_label0_cls0,34,0,33,1,{'dirt': 1}
Image__2023-03-08__10-26-40_label6_cls0,34,0,34,0,{}
Image__2023-02-23__14-28-03_label0_cls0,34,0,33,1,{'dirt': 1}
Image__2023-03-09__14-57-27_label1_cls0,34,0,32,2,{'dirt': 2}
Image__2023-03-01__13-16-32_label0_cls0,34,0,34,0,{}
Image__2023-12-11__12-34-47_label6_cls0,34,0,34,0,{}
Image__2023-03-06__14-08-17_label2_cls0,34,0,34,0,{}
Image__2023-02-27__13-58-53_label0_cls0,34,0,33,1,{'dirt': 1}
Image__2023-03-08__10-28-28_label0_cls0,34,0,34,0,{}
Image__2024-01-23__13-09-24_label0_cls0,34,0,34,0,{}
Image__2024-05-18__12-13-13_label0_cls0,34,0,34,0,{}
Image__2023-03-10__14-00-46_label0_cls0,34,0,33,1,{'dirt': 1}
Image__2023-03-14__14-17-22_label1_cls0,34,0,32,2,{'dirt': 2}
Image__2024-04-19__13-21-00_label0_cls0,34,0,34,0,{}
Image__2023-01-30__15-25-58_label0_cls0,34,0,33,1,{'dirt': 1}
Image__2023-02-28__13-51-38_label0_cls0,34,0,33,1,{'dirt': 1}
Image__2023-03-15__13-56-24_label0_cls0,33,0,31,2,{'dirt': 2}
Image__2023-05-24__12-47-50_label0_cls0,33,0,32,1,{'dirt': 1}
Image__2023-02-28__14-08-44_label1_cls0,33,0,33,0,{}
Image__2023-03-01__13-53-24_label0_cls0,33,0,33,0,{}
Image__2023-02-22__14-01-37_label0_cls0,33,0,32,1,{'dirt': 1}
Image__2023-02-28__14-27-58_label0_cls0,33,0,32,1,{'dirt': 1}
Image__2023-03-17__12-54-49_label0_cls0,33,0,32,1,{'dirt': 1}
Image__2023-03-10__13-05-53_label0_cls0,33,0,33,0,{}
Image__2023-03-15__14-06-49_label3_cls0,33,0,27,6,{'dirt': 6}
Image__2023-02-23__14-32-29_label0_cls0,33,0,32,1,{'dirt': 1}
Image__2023-03-02__13-28-40_label1_cls0,33,0,33,0,{}
Image__2023-03-15__14-06-49_label0_cls0,33,0,27,6,{'dirt': 6}
Image__2023-02-28__13-42-19_label0_cls0,33,0,32,1,{'dirt': 1}
Image__2023-03-02__13-27-41_label0_cls0,32,0,32,0,{}
Image__2023-03-08__10-32-03_label4_cls0,32,0,32,0,{}
Image__2023-02-22__13-50-13_label0_cls0,32,0,31,1,{'dirt': 1}
Image__2023-03-13__13-20-48_label0_cls0,32,0,31,1,{'dirt': 1}
Image__2023-03-02__14-25-26_label0_cls0,32,0,32,0,{}
Image__2023-03-08__10-45-05_label1_cls0,32,0,32,0,{}
Image__2024-04-06__12-35-06_label0_cls0,32,0,32,0,{}
Image__2023-02-23__14-10-04_label0_cls0,32,0,30,2,{'dirt': 2}
Image__2023-03-06__14-04-08_label0_cls0,32,0,32,0,{}
Image__2023-02-28__14-24-11_label0_cls0,32,0,32,0,{}
Image__2023-03-08__10-45-05_label0_cls0,32,0,32,0,{}
Image__2023-02-27__13-58-53_label4_cls0,32,0,31,1,{'dirt': 1}
Image__2024-01-30__13-09-16_label0_cls0,32,0,32,0,{}
Image__2023-03-01__13-46-05_label1_cls0,32,0,32,0,{}
Image__2023-02-23__14-33-16_label1_cls0,32,0,31,1,{'dirt': 1}
Image__2023-03-15__14-06-49_label4_cls0,32,0,26,6,{'dirt': 6}
Image__2023-02-28__14-08-44_label2_cls0,32,0,32,0,{}
Image__2023-02-27__13-54-43_label0_cls0,32,0,31,1,{'dirt': 1}
Image__2023-03-02__14-07-56_label0_cls0,32,0,31,1,{'dirt': 1}
Image__2023-12-11__12-30-03_label10_cls0,31,0,31,0,{}
Image__2023-12-11__12-34-47_label3_cls0,31,0,31,0,{}
Image__2023-03-01__13-17-59_label0_cls0,31,0,31,0,{}
Image__2023-02-24__10-43-53_label0_cls0,31,0,30,1,{'dirt': 1}
Image__2023-03-02__14-32-37_label0_cls0,31,0,31,0,{}
Image__2023-01-30__15-32-15_label0_cls0,31,0,30,1,{'dirt': 1}
Image__2023-03-01__13-37-40_label0_cls0,31,0,31,0,{}
Image__2023-02-27__14-01-33_label0_cls0,31,0,30,1,{'dirt': 1}
Image__2023-03-01__13-47-44_label0_cls0,31,0,31,0,{}
Image__2023-02-27__14-27-00_label1_cls0,31,0,27,4,{'dirt': 4}
Image__2023-02-27__13-55-11_label0_cls0,31,0,30,1,{'dirt': 1}
Image__2023-03-10__13-51-54_label0_cls0,31,0,30,1,{'dirt': 1}
Image__2024-03-16__13-54-02_label0_cls0,31,0,31,0,{}
Image__2024-01-09__13-24-26_label0_cls0,31,0,31,0,{}
Image__2023-03-13__12-37-21_label0_cls0,31,0,29,2,{'dirt': 2}
Image__2023-12-13__12-25-34_label0_cls0,31,0,31,0,{}
Image__2023-03-15__14-06-49_label1_cls0,31,0,25,6,{'dirt': 6}
Image__2023-10-30__13-26-00_label0_cls0,31,0,31,0,{}
Image__2023-03-15__14-22-11_label0_cls0,31,0,29,2,{'dirt': 2}
Image__2023-02-07__14-40-15_label0_cls0,31,0,30,1,{'dirt': 1}
Image__2023-03-06__14-08-17_label1_cls0,31,0,31,0,{}
Image__2023-03-01__13-34-31_label0_cls0,31,0,31,0,{}
Image__2024-04-06__12-32-51_label0_cls0,31,0,31,0,{}
Image__2023-03-14__13-56-19_label0_cls0,31,0,30,1,{'dirt': 1}
Image__2024-01-29__13-04-18_label0_cls0,31,0,31,0,{}
Image__2023-03-13__13-49-09_label0_cls0,30,0,29,1,{'dirt': 1}
Image__2024-04-18__12-11-57_label0_cls0,30,0,30,0,{}
Image__2024-01-30__13-12-24_label0_cls0,30,0,30,0,{}
Image__2023-03-01__13-36-20_label0_cls0,30,0,30,0,{}
Image__2023-12-27__13-14-11_label1_cls0,30,0,30,0,{}
Image__2024-04-16__12-11-23_label0_cls0,30,0,30,0,{}
Image__2023-02-28__13-47-49_label0_cls0,30,0,29,1,{'dirt': 1}
Image__2023-03-02__14-05-01_label0_cls0,30,0,29,1,{'dirt': 1}
Image__2024-01-23__13-07-15_label0_cls0,30,0,30,0,{}
Image__2023-03-15__13-30-17_label2_cls0,30,0,22,8,{'dirt': 8}
Image__2023-03-09__14-48-44_label0_cls0,30,0,30,0,{}
Image__2023-03-01__13-34-31_label1_cls0,30,0,30,0,{}
Image__2023-03-02__14-00-43_label0_cls0,30,0,29,1,{'dirt': 1}
Image__2023-02-27__13-53-00_label1_cls0,30,0,29,1,{'dirt': 1}
Image__2023-03-01__13-15-12_label0_cls0,30,0,30,0,{}
Image__2024-04-11__12-12-10_label0_cls0,30,0,30,0,{}
Image__2023-03-01__13-46-05_label0_cls0,30,0,30,0,{}
Image__2023-03-09__14-28-35_label0_cls0,30,0,30,0,{}
Image__2024-05-16__12-22-26_label0_cls0,30,0,30,0,{}
Image__2023-02-23__14-25-41_label0_cls0,30,0,29,1,{'dirt': 1}
Image__2024-05-23__12-18-16_label0_cls0,30,0,30,0,{}
Image__2023-02-27__13-52-08_label0_cls0,30,0,29,1,{'dirt': 1}
Image__2024-04-11__12-22-47_label0_cls0,30,0,30,0,{}
Image__2024-05-16__12-25-34_label0_cls0,30,0,30,0,{}
Image__2023-03-01__13-18-20_label0_cls0,30,0,30,0,{}
Image__2023-03-14__14-14-28_label0_cls0,30,0,29,1,{'dirt': 1}
Image__2023-03-01__13-30-57_label0_cls0,30,0,30,0,{}
Image__2023-03-02__14-24-21_label2_cls0,29,0,29,0,{}
Image__2024-03-28__13-32-10_label0_cls0,29,0,29,0,{}
Image__2023-12-26__12-58-47_label0_cls0,29,0,29,0,{}
Image__2023-03-02__14-20-55_label0_cls0,29,0,29,0,{}
Image__2023-03-02__13-32-36_label0_cls0,29,0,29,0,{}
Image__2023-12-11__12-30-03_label9_cls0,29,0,29,0,{}
Image__2023-03-08__10-43-33_label0_cls0,29,0,28,1,{'dirt': 1}
Image__2024-01-09__13-20-04_label3_cls0,29,0,29,0,{}
Image__2023-03-15__13-55-46_label2_cls0,29,0,26,3,{'dirt': 3}
Image__2023-03-13__13-13-05_label2_cls0,29,0,27,2,{'dirt': 2}
Image__2023-02-22__13-48-04_label0_cls0,29,0,28,1,{'dirt': 1}
Image__2023-12-11__12-30-03_label8_cls0,29,0,29,0,{}
Image__2023-03-10__13-42-49_label10_cls0,29,0,17,12,{'dirt': 12}
Image__2023-02-22__13-30-49_label2_cls0,29,0,27,2,{'dirt': 2}
Image__2023-12-27__13-07-12_label0_cls0,29,0,29,0,{}
Image__2023-03-10__13-42-49_label0_cls0,29,0,18,11,{'dirt': 11}
Image__2023-03-01__13-17-17_label0_cls0,29,0,29,0,{}
Image__2024-03-18__12-22-50_label0_cls0,29,0,29,0,{}
Image__2023-03-15__14-06-09_label0_cls0,29,0,28,1,{'dirt': 1}
Image__2023-12-11__12-30-03_label12_cls0,29,0,29,0,{}
Image__2023-02-22__14-08-31_label0_cls0,29,0,28,1,{'dirt': 1}
Image__2023-03-14__14-15-23_label0_cls0,28,0,27,1,{'dirt': 1}
Image__2023-03-13__13-20-16_label0_cls0,28,0,27,1,{'dirt': 1}
Image__2024-01-18__13-16-17_label0_cls0,28,0,28,0,{}
Image__2024-04-16__12-24-00_label0_cls0,28,0,28,0,{}
Image__2023-02-27__13-53-25_label1_cls0,28,0,27,1,{'dirt': 1}
Image__2023-02-28__13-56-00_label2_cls0,28,0,27,1,{'dirt': 1}
Image__2023-03-01__14-05-55_label0_cls0,28,0,28,0,{}
Image__2023-03-01__13-47-44_label1_cls0,28,0,28,0,{}
Image__2023-03-09__14-24-34_label0_cls0,28,0,28,0,{}
Image__2023-03-15__14-06-49_label2_cls0,28,0,22,6,{'dirt': 6}
Image__2023-03-08__10-44-17_label0_cls0,28,0,28,0,{}
Image__2023-03-06__13-34-02_label0_cls0,28,0,28,0,{}
Image__2023-03-01__13-34-05_label0_cls0,28,0,28,0,{}
Image__2023-02-22__13-44-17_label1_cls0,28,0,26,2,{'dirt': 2}
Image__2024-04-19__13-21-28_label0_cls0,28,0,28,0,{}
Image__2023-02-28__14-12-15_label0_cls0,28,0,28,0,{}
Image__2023-03-14__14-26-58_label0_cls0,28,0,26,2,{'dirt': 2}
Image__2024-01-23__13-10-43_label6_cls0,28,0,28,0,{}
Image__2023-02-22__14-05-49_label2_cls0,28,0,27,1,{'dirt': 1}
Image__2023-03-13__12-49-13_label2_cls0,28,0,24,4,{'dirt': 4}
Image__2024-03-26__13-29-05_label0_cls0,28,0,28,0,{}
Image__2023-03-14__14-26-58_label1_cls0,28,0,26,2,{'dirt': 2}
Image__2023-12-11__12-30-03_label5_cls0,28,0,28,0,{}
Image__2024-04-10__12-25-51_label0_cls0,28,0,28,0,{}
Image__2023-03-06__13-48-35_label0_cls0,28,0,28,0,{}
Image__2023-03-06__13-24-27_label0_cls0,27,0,27,0,{}
Image__2023-02-23__14-18-32_label0_cls0,27,0,26,1,{'dirt': 1}
Image__2024-02-21__12-28-19_label0_cls0,27,0,27,0,{}
Image__2024-05-17__12-21-43_label0_cls0,27,0,27,0,{}
Image__2023-03-06__13-40-07_label1_cls0,27,0,27,0,{}
Image__2023-03-13__12-51-01_label1_cls0,27,0,24,3,{'dirt': 3}
Image__2023-03-10__13-44-55_label2_cls0,27,0,25,2,{'dirt': 2}
Image__2023-12-16__13-30-23_label2_cls0,27,0,27,0,{}
Image__2023-03-08__10-40-55_label0_cls0,27,0,26,1,{'dirt': 1}
Image__2023-02-22__13-46-38_label0_cls0,27,0,26,1,{'dirt': 1}
Image__2023-03-02__13-28-40_label0_cls0,27,0,27,0,{}
Image__2023-03-13__13-27-27_label0_cls0,27,0,26,1,{'dirt': 1}
Image__2023-12-11__12-30-03_label2_cls0,27,0,27,0,{}
Image__2024-03-23__12-23-29_label0_cls0,27,0,27,0,{}
Image__2023-12-08__12-56-50_label0_cls0,27,0,27,0,{}
Image__2023-03-08__10-31-14_label0_cls0,27,0,27,0,{}
Image__2023-03-02__14-24-48_label0_cls0,27,0,27,0,{}
Image__2023-03-10__12-50-24_label0_cls0,27,0,25,2,{'dirt': 2}
Image__2023-03-02__13-33-31_label0_cls0,27,0,27,0,{}
Image__2023-02-28__14-20-13_label0_cls0,27,0,27,0,{}
Image__2024-01-23__13-10-43_label2_cls0,27,0,27,0,{}
Image__2023-02-28__14-10-43_label0_cls0,27,0,27,0,{}
Image__2023-12-11__12-34-47_label0_cls0,27,0,27,0,{}
Image__2023-02-22__13-33-18_label1_cls0,27,0,26,1,{'dirt': 1}
Image__2023-03-01__13-50-13_label0_cls0,27,0,27,0,{}
Image__2023-03-01__13-40-48_label0_cls0,27,0,27,0,{}
Image__2023-02-28__14-18-04_label0_cls0,27,0,27,0,{}
Image__2023-03-06__13-40-07_label0_cls0,27,0,27,0,{}
Image__2023-02-28__14-08-44_label3_cls0,27,0,27,0,{}
Image__2023-02-27__13-52-35_label0_cls0,27,0,26,1,{'dirt': 1}
Image__2023-02-27__14-27-00_label4_cls0,27,0,22,5,{'dirt': 5}
Image__2023-03-10__13-31-44_label0_cls0,27,0,27,0,{}
Image__2023-12-11__12-30-03_label1_cls0,26,0,26,0,{}
Image__2024-01-22__12-08-42_label0_cls0,26,0,26,0,{}
Image__2023-12-11__12-34-47_label2_cls0,26,0,26,0,{}
Image__2024-01-09__13-13-59_label1_cls0,26,0,26,0,{}
Image__2024-03-19__12-30-19_label0_cls0,26,0,26,0,{}
Image__2023-02-27__14-06-15_label1_cls0,26,0,25,1,{'dirt': 1}
Image__2023-03-14__14-08-39_label1_cls0,26,0,23,3,{'dirt': 3}
Image__2023-02-28__13-56-00_label0_cls0,26,0,25,1,{'dirt': 1}
Image__2023-02-27__13-53-00_label0_cls0,26,0,25,1,{'dirt': 1}
Image__2023-02-07__14-44-19_label0_cls0,26,0,25,1,{'dirt': 1}
Image__2023-02-27__14-10-08_label1_cls0,26,0,25,1,{'dirt': 1}
Image__2023-03-06__13-40-49_label1_cls0,26,0,26,0,{}
Image__2023-02-28__14-25-05_label0_cls0,26,0,26,0,{}
Image__2023-03-10__13-42-49_label2_cls0,26,0,15,11,{'dirt': 11}
Image__2024-04-06__12-38-57_label0_cls0,26,0,26,0,{}
Image__2024-04-10__12-28-53_label0_cls0,26,0,26,0,{}
Image__2023-03-10__13-19-30_label1_cls0,26,0,25,1,{'dirt': 1}
Image__2023-02-23__14-26-07_label0_cls0,26,0,25,1,{'dirt': 1}
Image__2023-02-27__14-27-00_label5_cls0,26,0,21,5,{'dirt': 5}
Image__2023-02-22__13-54-49_label0_cls0,26,0,25,1,{'dirt': 1}
Image__2023-02-23__14-10-04_label1_cls0,26,0,25,1,{'dirt': 1}
Image__2023-02-28__13-56-00_label1_cls0,26,0,25,1,{'dirt': 1}
Image__2023-03-08__10-26-40_label0_cls0,26,0,26,0,{}
Image__2024-04-17__12-13-54_label0_cls0,26,0,26,0,{}
Image__2023-03-02__13-27-41_label1_cls0,26,0,26,0,{}
Image__2023-03-09__14-57-27_label0_cls0,26,0,24,2,{'dirt': 2}
Image__2023-03-15__14-17-24_label0_cls0,26,0,25,1,{'dirt': 1}
Image__2024-05-14__12-10-59_label0_cls0,25,0,25,0,{}
Image__2023-03-02__14-30-48_label1_cls0,25,0,25,0,{}
Image__2023-03-06__13-56-57_label2_cls0,25,0,25,0,{}
Image__2023-02-01__15-25-18_label0_cls0,25,0,24,1,{'dirt': 1}
Image__2023-02-22__13-30-49_label1_cls0,25,0,23,2,{'dirt': 2}
Image__2024-01-09__13-20-04_label2_cls0,25,0,25,0,{}
Image__2023-02-24__10-43-04_label0_cls0,25,0,23,2,{'dirt': 2}
Image__2023-02-22__13-36-02_label2_cls0,25,0,24,1,{'dirt': 1}
Image__2023-02-28__14-07-26_label0_cls0,25,0,25,0,{}
Image__2023-03-13__12-37-21_label1_cls0,25,0,23,2,{'dirt': 2}
Image__2023-03-08__10-00-59_label1_cls0,25,0,23,2,{'dirt': 2}
Image__2023-03-14__14-27-33_label0_cls0,25,0,24,1,{'dirt': 1}
Image__2023-02-27__14-27-00_label2_cls0,25,0,21,4,{'dirt': 4}
Image__2023-03-01__13-51-28_label0_cls0,25,0,25,0,{}
Image__2023-01-30__15-27-33_label0_cls0,25,0,24,1,{'dirt': 1}
Image__2024-04-10__12-23-59_label0_cls0,25,0,25,0,{}
Image__2024-03-19__12-36-30_label0_cls0,25,0,25,0,{}
Image__2023-03-02__13-56-47_label0_cls0,25,0,25,0,{}
Image__2023-03-08__10-26-40_label2_cls0,25,0,25,0,{}
Image__2023-03-06__14-08-45_label0_cls0,25,0,25,0,{}
Image__2023-02-23__14-11-20_label0_cls0,25,0,24,1,{'dirt': 1}
Image__2023-03-08__10-45-47_label0_cls0,25,0,25,0,{}
Image__2023-03-08__10-24-51_label0_cls0,24,0,24,0,{}
Image__2024-04-19__13-13-05_label0_cls0,24,0,24,0,{}
Image__2023-02-27__14-40-20_label0_cls0,24,0,23,1,{'dirt': 1}
Image__2023-02-22__13-36-02_label1_cls0,24,0,23,1,{'dirt': 1}
Image__2023-02-28__14-03-25_label0_cls0,24,0,22,2,{'dirt': 2}
Image__2024-01-30__13-05-19_label0_cls0,24,0,24,0,{}
Image__2023-12-27__13-19-47_label0_cls0,24,0,24,0,{}
Image__2023-05-24__13-01-51_label0_cls0,24,0,23,1,{'dirt': 1}
Image__2023-12-13__12-25-34_label1_cls0,24,0,24,0,{}
Image__2023-12-11__12-35-41_label0_cls0,24,0,24,0,{}
Image__2023-03-15__13-46-41_label0_cls0,24,0,22,2,{'dirt': 2}
Image__2024-01-23__13-10-43_label7_cls0,24,0,24,0,{}
Image__2023-03-15__13-54-31_label0_cls0,24,0,23,1,{'dirt': 1}
Image__2023-03-13__13-24-25_label0_cls0,24,0,23,1,{'dirt': 1}
Image__2023-03-13__13-49-37_label0_cls0,24,0,23,1,{'dirt': 1}
Image__2023-03-13__13-32-13_label0_cls0,24,0,23,1,{'dirt': 1}
Image__2023-03-15__14-18-06_label0_cls0,24,0,23,1,{'dirt': 1}
Image__2023-03-01__13-50-37_label0_cls0,24,0,24,0,{}
Image__2023-03-15__14-01-47_label0_cls0,24,0,23,1,{'dirt': 1}
Image__2023-02-22__13-33-58_label2_cls0,24,0,23,1,{'dirt': 1}
Image__2023-03-02__13-57-10_label0_cls0,24,0,24,0,{}
Image__2023-03-06__13-58-13_label0_cls0,24,0,24,0,{}
Image__2023-03-02__14-24-21_label1_cls0,24,0,24,0,{}
Image__2023-02-28__14-27-58_label1_cls0,24,0,23,1,{'dirt': 1}
Image__2023-02-22__13-59-12_label0_cls0,24,0,23,1,{'dirt': 1}
Image__2023-03-17__13-26-03_label0_cls0,24,0,23,1,{'dirt': 1}
Image__2023-03-10__13-35-25_label0_cls0,23,0,23,0,{}
Image__2023-02-22__13-46-04_label0_cls0,23,0,22,1,{'dirt': 1}
Image__2023-02-28__14-29-17_label0_cls0,23,0,22,1,{'dirt': 1}
Image__2023-02-22__13-36-02_label0_cls0,23,0,22,1,{'dirt': 1}
Image__2023-03-08__10-24-51_label2_cls0,23,0,23,0,{}
Image__2023-03-02__14-16-50_label0_cls0,23,0,23,0,{}
Image__2024-03-14__12-20-42_label0_cls0,23,0,23,0,{}
Image__2024-01-27__12-38-29_label0_cls0,23,0,23,0,{}
Image__2023-03-13__13-13-05_label1_cls0,23,0,21,2,{'dirt': 2}
Image__2023-03-08__10-32-03_label0_cls0,23,0,23,0,{}
Image__2024-03-16__13-54-28_label0_cls0,22,0,22,0,{}
Image__2023-02-23__14-28-27_label0_cls0,22,0,21,1,{'dirt': 1}
Image__2023-03-14__14-08-39_label0_cls0,22,0,19,3,{'dirt': 3}
Image__2024-03-02__13-15-47_label0_cls0,22,0,22,0,{}
Image__2023-03-06__13-16-00_label1_cls0,22,0,22,0,{}
Image__2023-12-11__12-35-41_label1_cls0,22,0,22,0,{}
Image__2023-02-24__10-38-43_label3_cls0,22,0,21,1,{'dirt': 1}
Image__2023-02-24__10-31-22_label0_cls0,22,0,20,2,{'dirt': 2}
Image__2024-01-09__13-18-02_label0_cls0,22,0,22,0,{}
Image__2023-12-27__13-07-12_label1_cls0,22,0,22,0,{}
Image__2023-03-14__14-18-58_label0_cls0,22,0,21,1,{'dirt': 1}
Image__2024-04-06__12-43-26_label0_cls0,22,0,22,0,{}
Image__2024-01-09__13-20-04_label1_cls0,22,0,22,0,{}
Image__2023-03-14__14-01-51_label0_cls0,22,0,21,1,{'dirt': 1}
Image__2024-05-18__13-15-40_label0_cls0,22,0,22,0,{}
Image__2023-02-24__10-40-26_label0_cls0,22,0,21,1,{'dirt': 1}
Image__2023-12-16__13-30-23_label1_cls0,22,0,22,0,{}
Image__2023-03-06__13-56-57_label4_cls0,22,0,22,0,{}
Image__2023-03-17__12-52-35_label0_cls0,22,0,21,1,{'dirt': 1}
Image__2024-01-22__12-05-00_label0_cls0,22,0,22,0,{}
Image__2024-03-14__12-23-44_label0_cls0,22,0,22,0,{}
Image__2024-03-19__12-28-34_label0_cls0,22,0,22,0,{}
Image__2024-01-27__12-36-51_label0_cls0,22,0,22,0,{}
Image__2023-03-13__13-12-05_label0_cls0,22,0,19,3,{'dirt': 3}
Image__2023-03-15__14-25-32_label0_cls0,21,0,20,1,{'dirt': 1}
Image__2023-12-11__12-30-03_label6_cls0,21,0,21,0,{}
Image__2023-02-27__14-24-35_label1_cls0,21,0,20,1,{'dirt': 1}
Image__2023-03-02__14-32-37_label1_cls0,21,0,21,0,{}
Image__2024-02-26__12-40-49_label0_cls0,21,0,21,0,{}
Image__2023-02-23__14-33-16_label2_cls0,21,0,18,3,{'dirt': 3}
Image__2023-02-01__15-23-58_label1_cls0,21,0,20,1,{'dirt': 1}
Image__2024-01-23__13-11-15_label0_cls0,21,0,21,0,{}
Image__2023-12-16__13-40-23_label0_cls0,21,0,21,0,{}
Image__2023-12-26__13-01-30_label0_cls0,21,0,21,0,{}
Image__2023-02-23__14-33-16_label0_cls0,21,0,19,2,{'dirt': 2}
Image__2023-02-27__14-35-10_label0_cls0,21,0,20,1,{'dirt': 1}
Image__2023-03-10__13-27-29_label0_cls0,21,0,21,0,{}
Image__2023-03-02__13-55-49_label0_cls0,21,0,21,0,{}
Image__2023-03-13__13-13-05_label0_cls0,21,0,19,2,{'dirt': 2}
Image__2023-02-24__10-38-43_label2_cls0,21,0,20,1,{'dirt': 1}
Image__2023-03-08__10-23-18_label2_cls0,21,0,21,0,{}
Image__2024-01-29__13-06-40_label0_cls0,21,0,21,0,{}
Image__2024-05-17__12-22-10_label0_cls0,21,0,21,0,{}
Image__2024-01-29__13-06-40_label1_cls0,21,0,21,0,{}
Image__2023-03-08__10-43-57_label3_cls0,21,0,21,0,{}
Image__2023-02-28__14-06-56_label0_cls0,21,0,21,0,{}
Image__2023-02-28__14-10-10_label1_cls0,21,0,21,0,{}
Image__2024-01-23__13-10-43_label3_cls0,21,0,21,0,{}
Image__2023-02-28__14-22-28_label1_cls0,21,0,21,0,{}
Image__2023-12-16__13-38-03_label0_cls0,21,0,21,0,{}
Image__2023-02-27__14-11-17_label2_cls0,21,0,20,1,{'dirt': 1}
Image__2024-04-10__12-21-14_label0_cls0,21,0,21,0,{}
Image__2024-03-14__12-30-30_label0_cls0,21,0,21,0,{}
Image__2024-03-28__13-33-23_label0_cls0,21,0,21,0,{}
Image__2023-03-06__13-56-57_label1_cls0,20,0,20,0,{}
Image__2023-03-09__14-33-13_label0_cls0,20,0,20,0,{}
Image__2024-01-30__13-06-39_label0_cls0,20,0,20,0,{}
Image__2023-03-13__12-51-01_label0_cls0,20,0,17,3,{'dirt': 3}
Image__2024-01-27__12-33-30_label1_cls0,20,0,20,0,{}
Image__2023-03-06__13-52-51_label0_cls0,20,0,20,0,{}
Image__2023-02-27__14-31-40_label0_cls0,20,0,19,1,{'dirt': 1}
Image__2023-03-15__14-13-10_label0_cls0,20,0,19,1,{'dirt': 1}
Image__2023-03-08__10-09-31_label0_cls0,20,0,18,2,{'dirt': 2}
Image__2023-03-15__13-55-46_label1_cls0,20,0,17,3,{'dirt': 3}
Image__2023-12-13__12-24-16_label0_cls0,20,0,20,0,{}
Image__2023-03-10__13-42-49_label3_cls0,20,0,9,11,{'dirt': 11}
Image__2023-03-01__13-54-55_label0_cls0,20,0,20,0,{}
Image__2024-01-23__13-10-43_label5_cls0,20,0,20,0,{}
Image__2023-02-27__14-41-22_label1_cls0,20,0,19,1,{'dirt': 1}
Image__2023-02-23__14-30-23_label0_cls0,20,0,19,1,{'dirt': 1}
Image__2023-12-16__13-30-23_label0_cls0,20,0,20,0,{}
Image__2023-12-11__12-30-03_label11_cls0,20,0,20,0,{}
Image__2023-03-08__10-35-59_label0_cls0,20,0,20,0,{}
Image__2024-04-03__13-32-47_label0_cls0,20,0,20,0,{}
Image__2023-02-27__14-18-33_label0_cls0,20,0,19,1,{'dirt': 1}
Image__2024-01-23__13-10-43_label0_cls0,20,0,20,0,{}
Image__2024-03-19__12-29-09_label0_cls0,20,0,20,0,{}
Image__2023-03-13__13-48-03_label0_cls0,20,0,19,1,{'dirt': 1}
Image__2023-02-23__14-19-56_label0_cls0,20,0,19,1,{'dirt': 1}
Image__2024-04-16__12-19-21_label0_cls0,20,0,20,0,{}
Image__2024-05-16__12-14-12_label0_cls0,20,0,20,0,{}
Image__2023-03-02__14-03-10_label0_cls0,20,0,19,1,{'dirt': 1}
Image__2023-02-27__14-24-35_label0_cls0,20,0,19,1,{'dirt': 1}
Image__2023-12-26__13-01-30_label1_cls0,20,0,20,0,{}
Image__2023-03-02__14-05-30_label0_cls0,20,0,18,2,{'dirt': 2}
Image__2023-12-26__12-52-29_label0_cls0,19,0,19,0,{}
Image__2023-12-27__13-14-11_label0_cls0,19,0,19,0,{}
Image__2023-03-06__14-06-32_label0_cls0,19,0,19,0,{}
Image__2023-03-10__13-49-50_label0_cls0,19,0,15,4,{'dirt': 4}
Image__2023-03-09__14-35-41_label0_cls0,19,0,19,0,{}
Image__2023-02-27__13-49-11_label0_cls0,19,0,18,1,{'dirt': 1}
Image__2023-03-08__10-09-31_label1_cls0,19,0,17,2,{'dirt': 2}
Image__2023-03-15__13-55-46_label3_cls0,19,0,17,2,{'dirt': 2}
Image__2023-02-27__13-44-32_label0_cls0,19,0,18,1,{'dirt': 1}
Image__2023-12-16__13-43-58_label0_cls0,19,0,19,0,{}
Image__2024-01-23__13-10-43_label4_cls0,19,0,19,0,{}
Image__2024-01-30__13-04-56_label0_cls0,19,0,19,0,{}
Image__2024-04-06__12-36-06_label0_cls0,19,0,19,0,{}
Image__2023-02-27__14-08-32_label2_cls0,19,0,18,1,{'dirt': 1}
Image__2023-02-27__13-43-56_label0_cls0,19,0,18,1,{'dirt': 1}
Image__2023-03-06__13-27-29_label2_cls0,19,0,19,0,{}
Image__2023-02-22__13-50-38_label0_cls0,19,0,18,1,{'dirt': 1}
Image__2023-03-14__14-07-02_label0_cls0,19,0,16,3,{'dirt': 3}
Image__2024-04-09__12-20-56_label0_cls0,19,0,19,0,{}
Image__2023-03-10__12-49-43_label0_cls0,19,0,18,1,{'dirt': 1}
Image__2023-03-06__13-56-57_label5_cls0,19,0,19,0,{}
Image__2023-03-01__13-55-47_label0_cls0,19,0,19,0,{}
Image__2023-03-10__13-36-29_label0_cls0,19,0,17,2,{'dirt': 2}
Image__2023-10-30__13-28-27_label0_cls0,19,0,19,0,{}
Image__2023-02-28__13-42-46_label0_cls0,19,0,18,1,{'dirt': 1}
Image__2023-02-27__13-44-32_label2_cls0,19,0,18,1,{'dirt': 1}
Image__2024-04-06__12-32-20_label0_cls0,19,0,19,0,{}
Image__2023-01-30__15-35-24_label1_cls0,19,0,17,2,{'dirt': 2}
Image__2023-03-06__13-51-09_label0_cls0,19,0,19,0,{}
Image__2023-12-16__13-31-57_label0_cls0,19,0,19,0,{}
Image__2023-03-01__13-22-47_label0_cls0,19,0,19,0,{}
Image__2023-03-02__14-30-48_label0_cls0,19,0,19,0,{}
Image__2023-03-15__14-24-49_label2_cls0,19,0,15,4,{'dirt': 4}
Image__2024-04-17__12-20-27_label0_cls0,19,0,19,0,{}
Image__2023-03-10__12-52-56_label0_cls0,19,0,19,0,{}
Image__2023-02-24__10-31-22_label1_cls0,18,0,16,2,{'dirt': 2}
Image__2024-04-18__12-16-38_label0_cls0,18,0,18,0,{}
Image__2023-03-06__13-27-00_label0_cls0,18,0,18,0,{}
Image__2023-12-11__12-35-41_label2_cls0,18,0,18,0,{}
Image__2023-03-10__13-52-24_label1_cls0,18,0,16,2,{'dirt': 2}
Image__2023-02-27__14-20-21_label1_cls0,18,0,17,1,{'dirt': 1}
Image__2023-12-11__12-30-03_label3_cls0,18,0,18,0,{}
Image__2023-03-10__13-15-40_label0_cls0,18,0,18,0,{}
Image__2023-02-24__10-26-13_label0_cls0,18,0,17,1,{'dirt': 1}
Image__2023-03-10__13-17-53_label0_cls0,18,0,16,2,{'dirt': 2}
Image__2024-01-30__13-15-07_label0_cls0,18,0,18,0,{}
Image__2023-02-27__13-57-22_label0_cls0,18,0,17,1,{'dirt': 1}
Image__2023-12-11__12-35-41_label5_cls0,18,0,18,0,{}
Image__2024-01-30__13-05-54_label0_cls0,18,0,18,0,{}
Image__2023-03-06__14-07-41_label0_cls0,18,0,18,0,{}
Image__2023-03-15__13-46-41_label1_cls0,18,0,16,2,{'dirt': 2}
Image__2023-02-24__10-38-03_label0_cls0,18,0,17,1,{'dirt': 1}
Image__2023-03-01__13-56-12_label0_cls0,18,0,18,0,{}
Image__2023-12-11__12-30-03_label7_cls0,18,0,18,0,{}
Image__2023-03-14__13-31-34_label0_cls0,18,0,17,1,{'dirt': 1}
Image__2023-03-06__13-33-34_label0_cls0,18,0,18,0,{}
Image__2024-05-21__12-16-05_label0_cls0,18,0,18,0,{}
Image__2023-03-02__14-33-38_label3_cls0,18,0,18,0,{}
Image__2024-03-23__12-21-59_label0_cls0,18,0,18,0,{}
Image__2023-01-30__15-20-17_label0_cls0,18,0,17,1,{'dirt': 1}
Image__2023-03-10__13-32-57_label0_cls0,18,0,18,0,{}
Image__2023-02-28__14-24-37_label0_cls0,18,0,18,0,{}
Image__2023-02-27__14-20-21_label0_cls0,18,0,17,1,{'dirt': 1}
Image__2023-02-23__14-21-53_label0_cls0,18,0,16,2,{'dirt': 2}
Image__2023-03-08__10-26-40_label7_cls0,18,0,18,0,{}
Image__2023-03-06__13-44-26_label0_cls0,18,0,18,0,{}
Image__2023-03-15__13-37-40_label0_cls0,18,0,17,1,{'dirt': 1}
Image__2023-03-01__13-58-45_label0_cls0,18,0,18,0,{}
Image__2023-02-27__14-36-24_label0_cls0,17,0,15,2,{'dirt': 2}
Image__2024-04-11__12-18-02_label0_cls0,17,0,17,0,{}
Image__2023-03-14__14-06-31_label0_cls0,17,0,16,1,{'dirt': 1}
Image__2023-03-10__13-36-29_label1_cls0,17,0,15,2,{'dirt': 2}
Image__2024-03-23__12-34-29_label0_cls0,17,0,17,0,{}
Image__2023-03-06__13-40-49_label0_cls0,17,0,17,0,{}
Image__2023-03-15__14-11-33_label0_cls0,17,0,15,2,{'dirt': 2}
Image__2023-03-10__13-42-49_label6_cls0,17,0,6,11,{'dirt': 11}
Image__2023-03-10__13-56-38_label1_cls0,17,0,15,2,{'dirt': 2}
Image__2023-12-11__12-30-03_label4_cls0,17,0,17,0,{}
Image__2023-12-13__12-34-17_label1_cls0,17,0,17,0,{}
Image__2023-02-27__14-11-17_label3_cls0,17,0,16,1,{'dirt': 1}
Image__2023-03-15__13-39-06_label0_cls0,17,0,14,3,{'dirt': 3}
Image__2023-03-06__13-31-15_label0_cls0,17,0,17,0,{}
Image__2024-04-11__12-22-00_label0_cls0,17,0,17,0,{}
Image__2023-03-13__12-47-58_label0_cls0,17,0,15,2,{'dirt': 2}
Image__2023-02-22__13-33-58_label1_cls0,17,0,16,1,{'dirt': 1}
Image__2023-03-02__14-18-36_label0_cls0,17,0,17,0,{}
Image__2023-03-10__13-42-49_label5_cls0,17,0,6,11,{'dirt': 11}
Image__2024-01-09__13-10-35_label0_cls0,17,0,17,0,{}
Image__2023-02-27__13-54-16_label1_cls0,17,0,16,1,{'dirt': 1}
Image__2023-02-28__14-05-53_label2_cls0,17,0,17,0,{}
Image__2024-03-14__12-34-20_label0_cls0,17,0,17,0,{}
Image__2024-04-06__12-42-19_label0_cls0,17,0,17,0,{}
Image__2023-12-08__12-53-02_label4_cls0,17,0,17,0,{}
Image__2023-03-13__13-31-38_label0_cls0,17,0,16,1,{'dirt': 1}
Image__2024-01-23__13-10-43_label1_cls0,17,0,17,0,{}
Image__2023-03-01__13-16-32_label2_cls0,17,0,17,0,{}
Image__2023-03-08__10-13-32_label0_cls0,17,0,17,0,{}
Image__2023-03-08__10-41-28_label0_cls0,17,0,16,1,{'dirt': 1}
Image__2023-03-02__14-18-14_label0_cls0,17,0,17,0,{}
Image__2023-03-01__13-56-59_label0_cls0,17,0,17,0,{}
Image__2023-03-14__13-58-53_label0_cls0,16,0,15,1,{'dirt': 1}
Image__2023-03-01__13-55-47_label1_cls0,16,0,16,0,{}
Image__2023-02-22__13-47-06_label0_cls0,16,0,15,1,{'dirt': 1}
Image__2023-02-28__14-08-10_label0_cls0,16,0,16,0,{}
Image__2023-02-27__14-08-32_label1_cls0,16,0,14,2,{'dirt': 2}
Image__2023-03-01__13-48-32_label0_cls0,16,0,16,0,{}
Image__2024-04-03__13-26-00_label0_cls0,16,0,16,0,{}
Image__2024-04-09__12-17-49_label0_cls0,16,0,16,0,{}
Image__2023-02-23__14-17-37_label0_cls0,16,0,15,1,{'dirt': 1}
Image__2023-03-13__13-12-05_label2_cls0,16,0,13,3,{'dirt': 3}
Image__2023-12-11__12-38-47_label3_cls0,16,0,16,0,{}
Image__2023-03-13__12-58-07_label3_cls0,16,0,11,5,{'dirt': 5}
Image__2023-03-16__13-47-36_label0_cls0,16,0,15,1,{'dirt': 1}
Image__2023-03-10__13-42-49_label9_cls0,16,0,5,11,{'dirt': 11}
Image__2024-04-11__12-16-54_label0_cls0,16,0,16,0,{}
Image__2023-03-10__13-44-55_label1_cls0,16,0,14,2,{'dirt': 2}
Image__2024-04-03__13-28-27_label0_cls0,16,0,16,0,{}
Image__2023-01-30__15-35-24_label0_cls0,16,0,14,2,{'dirt': 2}
Image__2023-02-27__14-01-09_label1_cls0,16,0,15,1,{'dirt': 1}
Image__2024-01-27__12-33-30_label0_cls0,16,0,16,0,{}
Image__2023-03-09__12-58-49_label0_cls0,16,0,16,0,{}
Image__2023-03-10__13-56-38_label0_cls0,16,0,14,2,{'dirt': 2}
Image__2023-12-26__13-01-30_label2_cls0,16,0,16,0,{}
Image__2023-03-09__14-56-55_label0_cls0,16,0,15,1,{'dirt': 1}
Image__2024-05-23__12-19-25_label0_cls0,16,0,16,0,{}
Image__2024-05-21__12-20-32_label0_cls0,16,0,16,0,{}
Image__2023-02-22__13-49-17_label2_cls0,16,0,15,1,{'dirt': 1}
Image__2023-03-06__13-27-00_label1_cls0,15,0,15,0,{}
Image__2023-03-10__13-42-49_label4_cls0,15,0,4,11,{'dirt': 11}
Image__2023-03-02__13-36-04_label0_cls0,15,0,15,0,{}
Image__2023-02-23__14-24-41_label0_cls0,15,0,14,1,{'dirt': 1}
Image__2023-02-27__13-54-16_label0_cls0,15,0,14,1,{'dirt': 1}
Image__2023-02-22__13-49-17_label1_cls0,15,0,14,1,{'dirt': 1}
Image__2023-02-28__14-03-25_label1_cls0,15,0,13,2,{'dirt': 2}
Image__2023-03-13__13-02-19_label0_cls0,15,0,14,1,{'dirt': 1}
Image__2023-12-26__13-03-09_label1_cls0,15,0,15,0,{}
Image__2023-03-14__14-16-12_label0_cls0,15,0,12,3,{'dirt': 3}
Image__2023-03-01__13-36-45_label0_cls0,15,0,15,0,{}
Image__2024-03-28__13-32-48_label0_cls0,15,0,15,0,{}
Image__2023-03-02__14-22-08_label0_cls0,15,0,15,0,{}
Image__2024-05-18__13-16-43_label0_cls0,15,0,15,0,{}
Image__2023-03-10__13-51-23_label0_cls0,15,0,13,2,{'dirt': 2}
Image__2023-03-13__12-58-07_label2_cls0,15,0,10,5,{'dirt': 5}
Image__2024-04-10__12-21-42_label0_cls0,15,0,15,0,{}
Image__2023-12-13__12-33-36_label0_cls0,15,0,15,0,{}
Image__2023-03-14__14-07-34_label0_cls0,15,0,12,3,{'dirt': 3}
Image__2024-04-11__12-13-27_label0_cls0,15,0,15,0,{}
Image__2024-04-10__12-19-38_label0_cls0,15,0,15,0,{}
Image__2023-03-08__10-24-51_label1_cls0,15,0,15,0,{}
Image__2023-03-02__13-51-11_label0_cls0,15,0,15,0,{}
Image__2024-03-14__12-22-39_label0_cls0,15,0,15,0,{}
Image__2023-03-02__14-24-21_label0_cls0,15,0,15,0,{}
Image__2023-03-01__13-30-29_label0_cls0,15,0,15,0,{}
Image__2023-02-27__14-10-08_label0_cls0,15,0,14,1,{'dirt': 1}
Image__2023-02-27__14-41-22_label0_cls0,15,0,14,1,{'dirt': 1}
Image__2023-03-06__13-46-55_label0_cls0,15,0,15,0,{}
Image__2023-03-02__14-17-13_label0_cls0,15,0,15,0,{}
Image__2023-02-28__13-50-49_label0_cls0,15,0,14,1,{'dirt': 1}
Image__2024-05-16__12-21-27_label0_cls0,15,0,15,0,{}
Image__2023-02-28__14-05-53_label0_cls0,15,0,15,0,{}
Image__2023-03-01__13-21-29_label0_cls0,14,0,14,0,{}
Image__2023-02-27__14-11-51_label1_cls0,14,0,13,1,{'dirt': 1}
Image__2023-03-10__13-42-49_label8_cls0,14,0,3,11,{'dirt': 11}
Image__2023-03-10__13-43-33_label1_cls0,14,0,11,3,{'dirt': 3}
Image__2023-03-15__13-39-06_label1_cls0,14,0,11,3,{'dirt': 3}
Image__2024-01-30__13-14-01_label0_cls0,14,0,14,0,{}
Image__2024-05-23__12-21-37_label0_cls0,14,0,14,0,{}
Image__2023-03-17__13-18-26_label0_cls0,14,0,13,1,{'dirt': 1}
Image__2023-02-22__13-31-22_label0_cls0,14,0,12,2,{'dirt': 2}
Image__2023-03-01__13-29-12_label0_cls0,14,0,14,0,{}
Image__2023-02-27__14-20-59_label0_cls0,14,0,13,1,{'dirt': 1}
Image__2024-05-17__12-18-56_label0_cls0,14,0,14,0,{}
Image__2024-04-11__12-24-33_label0_cls0,14,0,14,0,{}
Image__2023-02-27__13-44-32_label1_cls0,14,0,13,1,{'dirt': 1}
Image__2024-05-17__12-13-27_label0_cls0,14,0,14,0,{}
Image__2023-03-16__13-54-01_label0_cls0,14,0,13,1,{'dirt': 1}
Image__2023-03-08__10-39-48_label0_cls0,14,0,13,1,{'dirt': 1}
Image__2023-03-13__13-01-33_label0_cls0,14,0,13,1,{'dirt': 1}
Image__2023-03-10__13-51-23_label1_cls0,14,0,12,2,{'dirt': 2}
Image__2024-01-30__13-09-42_label0_cls0,14,0,14,0,{}
Image__2023-03-10__13-49-50_label1_cls0,14,0,10,4,{'dirt': 4}
Image__2024-05-21__12-17-17_label0_cls0,14,0,14,0,{}
Image__2024-04-17__12-19-26_label0_cls0,14,0,14,0,{}
Image__2023-02-28__13-54-00_label0_cls0,14,0,13,1,{'dirt': 1}
Image__2023-03-10__13-49-50_label2_cls0,14,0,10,4,{'dirt': 4}
Image__2023-02-28__14-28-50_label0_cls0,14,0,13,1,{'dirt': 1}
Image__2023-03-06__13-56-57_label3_cls0,14,0,14,0,{}
Image__2024-04-16__12-21-28_label0_cls0,14,0,14,0,{}
Image__2023-02-28__13-59-52 - コピー_label0_cls0,14,0,13,1,{'dirt': 1}
Image__2023-03-10__13-49-50_label3_cls0,14,0,10,4,{'dirt': 4}
Image__2023-02-22__14-06-25_label0_cls0,13,0,12,1,{'dirt': 1}
Image__2023-03-06__14-02-28_label0_cls0,13,0,13,0,{}
Image__2024-04-25__13-15-12_label0_cls0,13,0,13,0,{}
Image__2023-03-10__13-39-06_label0_cls0,13,0,12,1,{'dirt': 1}
Image__2023-03-10__13-44-55_label0_cls0,13,0,11,2,{'dirt': 2}
Image__2023-02-22__13-33-58_label0_cls0,13,0,12,1,{'dirt': 1}
Image__2023-01-30__15-31-35_label0_cls0,13,0,12,1,{'dirt': 1}
Image__2023-12-11__12-35-41_label3_cls0,13,0,13,0,{}
Image__2023-03-01__13-30-00_label0_cls0,13,0,13,0,{}
Image__2023-12-16__13-39-01_label0_cls0,13,0,13,0,{}
Image__2024-03-26__13-26-25_label0_cls0,13,0,13,0,{}
Image__2023-03-10__13-43-33_label2_cls0,13,0,10,3,{'dirt': 3}
Image__2024-03-14__12-29-43_label0_cls0,13,0,13,0,{}
Image__2023-02-22__13-26-58_label5_cls0,13,0,11,2,{'dirt': 2}
Image__2024-04-18__12-23-50_label0_cls0,13,0,13,0,{}
Image__2023-03-10__13-28-03_label0_cls0,13,0,13,0,{}
Image__2023-03-14__13-56-55_label0_cls0,13,0,5,8,{'dirt': 8}
Image__2023-02-28__14-22-28_label0_cls0,13,0,13,0,{}
Image__2023-03-06__13-58-48_label0_cls0,13,0,13,0,{}
Image__2023-02-27__13-51-14_label0_cls0,13,0,12,1,{'dirt': 1}
Image__2023-02-24__10-32-45_label0_cls0,13,0,12,1,{'dirt': 1}
Image__2023-02-24__10-38-43_label1_cls0,13,0,12,1,{'dirt': 1}
Image__2023-02-27__14-27-00_label3_cls0,13,0,8,5,{'dirt': 5}
Image__2023-03-13__13-37-55_label0_cls0,13,0,11,2,{'dirt': 2}
Image__2023-03-10__13-42-49_label7_cls0,13,0,2,11,{'dirt': 11}
Image__2023-12-11__12-38-47_label0_cls0,13,0,13,0,{}
Image__2023-03-06__13-16-00_label0_cls0,13,0,13,0,{}
Image__2023-03-10__13-43-33_label0_cls0,13,0,10,3,{'dirt': 3}
Image__2023-12-26__13-04-49_label1_cls0,13,0,13,0,{}
Image__2023-03-08__10-07-30_label1_cls0,13,0,11,2,{'dirt': 2}
Image__2023-12-08__12-53-02_label5_cls0,13,0,13,0,{}
Image__2023-03-01__13-40-15_label0_cls0,13,0,13,0,{}
Image__2023-01-30__15-30-36_label0_cls0,13,0,12,1,{'dirt': 1}
Image__2023-03-14__14-11-04_label0_cls0,13,0,12,1,{'dirt': 1}
Image__2023-12-13__12-34-17_label0_cls0,13,0,13,0,{}
Image__2023-10-30__13-31-46_label0_cls0,13,0,13,0,{}
Image__2023-03-02__13-29-14_label0_cls0,13,0,13,0,{}
Image__2023-03-13__12-35-14_label0_cls0,13,0,12,1,{'dirt': 1}
Image__2024-03-19__12-21-19_label0_cls0,12,0,12,0,{}
Image__2023-03-09__14-38-51_label1_cls0,12,0,12,0,{}
Image__2024-02-28__12-23-31_label0_cls0,12,0,12,0,{}
Image__2023-03-02__14-23-34_label0_cls0,12,0,12,0,{}
Image__2023-03-02__13-52-50_label0_cls0,12,0,12,0,{}
Image__2023-03-08__10-00-18_label1_cls0,12,0,12,0,{}
Image__2024-05-18__13-17-45_label0_cls0,12,0,12,0,{}
Image__2023-03-08__10-00-59_label0_cls0,12,0,12,0,{}
Image__2023-02-22__13-26-58_label4_cls0,12,0,10,2,{'dirt': 2}
Image__2023-03-14__14-07-02_label1_cls0,12,0,9,3,{'dirt': 3}
Image__2023-12-16__13-31-11_label0_cls0,12,0,12,0,{}
Image__2023-03-02__13-28-09_label0_cls0,12,0,12,0,{}
Image__2023-03-06__13-16-00_label3_cls0,12,0,12,0,{}
Image__2024-01-29__13-04-49_label0_cls0,12,0,12,0,{}
Image__2023-02-24__10-33-34_label0_cls0,12,0,11,1,{'dirt': 1}
Image__2023-02-22__13-42-38_label0_cls0,12,0,11,1,{'dirt': 1}
Image__2024-01-09__13-15-40_label2_cls0,12,0,12,0,{}
Image__2024-03-19__12-30-57_label0_cls0,12,0,12,0,{}
Image__2023-02-23__14-31-47_label0_cls0,12,0,11,1,{'dirt': 1}
Image__2023-02-27__14-05-45_label0_cls0,12,0,11,1,{'dirt': 1}
Image__2024-01-09__13-15-40_label1_cls0,12,0,12,0,{}
Image__2023-03-06__13-55-18_label0_cls0,12,0,12,0,{}
Image__2023-02-28__14-01-27_label0_cls0,12,0,11,1,{'dirt': 1}
Image__2023-03-14__14-07-34_label1_cls0,12,0,9,3,{'dirt': 3}
Image__2023-03-14__14-06-05_label1_cls0,12,0,8,4,{'dirt': 4}
Image__2023-03-13__13-26-55_label0_cls0,12,0,11,1,{'dirt': 1}
Image__2023-02-22__13-49-17_label0_cls0,12,0,11,1,{'dirt': 1}
Image__2023-12-08__12-55-22_label1_cls0,12,0,12,0,{}
Image__2023-03-13__13-37-55_label1_cls0,12,0,10,2,{'dirt': 2}
Image__2024-04-16__12-25-51_label0_cls0,12,0,12,0,{}
Image__2023-02-28__14-28-28_label0_cls0,12,0,11,1,{'dirt': 1}
Image__2023-03-06__14-04-33_label0_cls0,12,0,12,0,{}
Image__2023-03-09__14-29-33_label0_cls0,12,0,12,0,{}
Image__2023-02-27__14-27-00_label0_cls0,12,0,9,3,{'dirt': 3}
Image__2023-02-22__13-26-58_label1_cls0,12,0,10,2,{'dirt': 2}
Image__2024-05-21__12-12-18_label0_cls0,12,0,12,0,{}
Image__2023-12-16__13-40-23_label1_cls0,12,0,12,0,{}
Image__2023-03-15__14-16-55_label0_cls0,12,0,11,1,{'dirt': 1}
Image__2023-02-22__14-09-00_label0_cls0,12,0,10,2,{'dirt': 2}
Image__2024-04-19__13-19-50_label0_cls0,12,0,12,0,{}
Image__2023-02-28__13-59-52_label0_cls0,12,0,11,1,{'dirt': 1}
Image__2023-02-27__14-27-36_label0_cls0,12,0,11,1,{'dirt': 1}
Image__2023-03-06__13-56-57_label0_cls0,12,0,12,0,{}
Image__2023-03-06__13-40-49_label2_cls0,12,0,12,0,{}
Image__2024-01-09__13-15-40_label0_cls0,11,0,11,0,{}
Image__2023-03-15__13-34-58_label0_cls0,11,0,10,1,{'dirt': 1}
Image__2024-03-23__12-27-57_label0_cls0,11,0,11,0,{}
Image__2023-03-10__13-48-13_label0_cls0,11,0,8,3,{'dirt': 3}
Image__2024-05-17__12-12-18_label0_cls0,11,0,11,0,{}
Image__2023-12-11__12-35-41_label4_cls0,11,0,11,0,{}
Image__2023-02-22__14-02-07_label1_cls0,11,0,10,1,{'dirt': 1}
Image__2023-02-22__14-06-25_label6_cls0,11,0,10,1,{'dirt': 1}
Image__2023-03-14__14-06-05_label2_cls0,11,0,8,3,{'dirt': 3}
Image__2024-02-28__12-25-34_label0_cls0,11,0,11,0,{}
Image__2023-03-15__14-22-50_label0_cls0,11,0,10,1,{'dirt': 1}
Image__2023-03-01__13-36-45_label1_cls0,11,0,11,0,{}
Image__2023-02-28__14-28-28_label2_cls0,11,0,9,2,{'dirt': 2}
Image__2024-04-11__12-29-46_label0_cls0,11,0,11,0,{}
Image__2023-03-08__10-13-32_label1_cls0,11,0,11,0,{}
Image__2023-02-22__13-55-23_label0_cls0,11,0,10,1,{'dirt': 1}
Image__2023-02-28__14-26-35_label0_cls0,11,0,10,1,{'dirt': 1}
Image__2023-03-13__12-36-41_label0_cls0,11,0,10,1,{'dirt': 1}
Image__2023-03-13__13-12-05_label1_cls0,11,0,8,3,{'dirt': 3}
Image__2023-12-11__12-27-52_label0_cls0,11,0,11,0,{}
Image__2024-05-16__12-28-45_label0_cls0,11,0,11,0,{}
Image__2023-03-06__13-45-24_label0_cls0,11,0,11,0,{}
Image__2023-02-28__14-20-42_label1_cls0,11,0,11,0,{}
Image__2023-03-09__14-38-51_label6_cls0,11,0,7,4,{'dirt': 4}
Image__2024-03-23__12-33-04_label0_cls0,11,0,11,0,{}
Image__2023-02-27__14-08-32_label0_cls0,11,0,9,2,{'dirt': 2}
Image__2023-03-15__13-46-02_label4_cls0,11,0,4,7,{'dirt': 7}
Image__2023-03-08__10-07-30_label2_cls0,11,0,9,2,{'dirt': 2}
Image__2023-03-06__13-38-01_label6_cls0,11,0,11,0,{}
Image__2024-05-17__12-28-20_label0_cls0,11,0,11,0,{}
Image__2024-04-18__12-30-11_label0_cls0,11,0,11,0,{}
Image__2023-03-10__12-49-43_label1_cls0,11,0,10,1,{'dirt': 1}
Image__2023-02-28__14-28-28_label1_cls0,11,0,9,2,{'dirt': 2}
Image__2023-03-08__10-26-40_label5_cls0,11,0,11,0,{}
Image__2024-03-19__12-22-21_label0_cls0,11,0,11,0,{}
Image__2023-02-22__14-09-00_label1_cls0,11,0,9,2,{'dirt': 2}
Image__2023-12-08__12-55-22_label0_cls0,11,0,11,0,{}
Image__2023-02-22__13-31-22_label1_cls0,11,0,9,2,{'dirt': 2}
Image__2023-02-22__13-33-18_label0_cls0,10,0,9,1,{'dirt': 1}
Image__2023-03-06__13-16-00_label4_cls0,10,0,10,0,{}
Image__2023-03-14__13-56-55_label3_cls0,10,0,2,8,{'dirt': 8}
Image__2023-12-16__13-30-23_label13_cls0,10,0,10,0,{}
Image__2024-03-28__13-29-41_label0_cls0,10,0,10,0,{}
Image__2023-03-13__13-05-30_label1_cls0,10,0,8,2,{'dirt': 2}
Image__2023-02-28__14-26-03_label0_cls0,10,0,9,1,{'dirt': 1}
Image__2023-03-17__13-08-08_label0_cls0,10,0,9,1,{'dirt': 1}
Image__2023-02-22__14-06-25_label4_cls0,10,0,9,1,{'dirt': 1}
Image__2024-01-22__12-05-41_label0_cls0,10,0,10,0,{}
Image__2023-02-22__13-31-22_label2_cls0,10,0,8,2,{'dirt': 2}
Image__2023-02-28__14-30-51_label0_cls0,10,0,8,2,{'dirt': 2}
Image__2023-03-14__13-56-55_label7_cls0,10,0,2,8,{'dirt': 8}
Image__2023-03-08__10-02-59_label2_cls0,10,0,7,3,{'dirt': 3}
Image__2023-03-08__10-02-59_label1_cls0,10,0,7,3,{'dirt': 3}
Image__2023-03-17__13-03-01_label0_cls0,10,0,9,1,{'dirt': 1}
Image__2024-04-11__12-15-36_label0_cls0,10,0,10,0,{}
Image__2023-03-02__14-20-07_label1_cls0,10,0,10,0,{}
Image__2023-03-13__13-44-50_label0_cls0,10,0,9,1,{'dirt': 1}
Image__2023-05-24__12-59-25_label0_cls0,10,0,8,2,{'dirt': 2}
Image__2023-12-11__12-28-55_label1_cls0,10,0,10,0,{}
Image__2023-03-08__10-46-14_label0_cls0,10,0,10,0,{}
Image__2023-02-22__13-29-43_label1_cls0,10,0,9,1,{'dirt': 1}
Image__2023-03-01__14-00-49_label1_cls0,10,0,10,0,{}
Image__2023-03-06__13-46-16_label0_cls0,10,0,10,0,{}
Image__2023-03-01__13-27-47_label11_cls0,10,0,10,0,{}
Image__2023-03-16__13-45-40_label0_cls0,10,0,9,1,{'dirt': 1}
Image__2023-02-22__13-47-06_label1_cls0,10,0,9,1,{'dirt': 1}
Image__2023-12-26__13-05-27_label0_cls0,10,0,10,0,{}
Image__2023-05-24__12-46-16_label0_cls0,10,0,9,1,{'dirt': 1}
Image__2023-02-22__13-26-58_label0_cls0,10,0,8,2,{'dirt': 2}
Image__2023-03-14__14-03-05_label2_cls0,10,0,7,3,{'dirt': 3}
Image__2023-03-02__13-36-32_label0_cls0,10,0,10,0,{}
Image__2023-03-09__14-38-51_label0_cls0,10,0,10,0,{}
Image__2023-02-22__13-59-43_label0_cls0,10,0,9,1,{'dirt': 1}
Image__2024-01-22__12-05-41_label1_cls0,10,0,10,0,{}
Image__2023-02-28__14-09-10_label0_cls0,10,0,10,0,{}
Image__2023-03-02__13-27-41_label2_cls0,10,0,10,0,{}
Image__2023-03-13__13-23-51_label0_cls0,10,0,9,1,{'dirt': 1}
Image__2024-01-29__13-05-58_label0_cls0,10,0,10,0,{}
Image__2023-03-16__13-50-32_label1_cls0,10,0,8,2,{'dirt': 2}
Image__2023-01-30__15-29-01_label0_cls0,10,0,9,1,{'dirt': 1}
Image__2024-04-03__13-27-57_label0_cls0,10,0,10,0,{}
Image__2023-03-16__13-41-08_label0_cls0,10,0,8,2,{'dirt': 2}
Image__2023-03-17__13-04-20_label1_cls0,9,0,3,6,{'dirt': 6}
Image__2024-05-18__13-18-11_label0_cls0,9,0,9,0,{}
Image__2023-02-22__13-32-36_label0_cls0,9,0,8,1,{'dirt': 1}
Image__2023-03-08__10-30-14_label1_cls0,9,0,9,0,{}
Image__2023-03-08__10-00-18_label2_cls0,9,0,9,0,{}
Image__2023-03-14__13-56-55_label4_cls0,9,0,1,8,{'dirt': 8}
Image__2023-03-02__14-20-07_label0_cls0,9,0,9,0,{}
Image__2024-01-22__12-11-45_label1_cls0,9,0,9,0,{}
Image__2023-02-22__13-26-58_label3_cls0,9,0,7,2,{'dirt': 2}
Image__2023-02-07__14-38-28_label2_cls0,9,0,8,1,{'dirt': 1}
Image__2023-03-16__13-54-48_label0_cls0,9,0,8,1,{'dirt': 1}
Image__2024-01-30__13-05-54_label2_cls0,9,0,9,0,{}
Image__2023-02-22__13-29-43_label0_cls0,9,0,8,1,{'dirt': 1}
Image__2023-03-10__13-03-42_label0_cls0,9,0,9,0,{}
Image__2024-04-19__13-16-37_label0_cls0,9,0,9,0,{}
Image__2023-03-15__13-48-36_label0_cls0,9,0,8,1,{'dirt': 1}
Image__2023-03-02__14-26-32_label0_cls0,9,0,9,0,{}
Image__2023-02-07__14-38-28_label5_cls0,9,0,6,3,{'dirt': 3}
Image__2024-03-19__12-18-39_label0_cls0,9,0,9,0,{}
Image__2023-12-16__13-39-01_label1_cls0,9,0,9,0,{}
Image__2024-05-23__12-13-44_label0_cls0,9,0,9,0,{}
Image__2023-03-08__10-30-14_label0_cls0,9,0,9,0,{}
Image__2023-02-24__10-38-43_label0_cls0,9,0,8,1,{'dirt': 1}
Image__2023-03-15__13-55-46_label0_cls0,9,0,7,2,{'dirt': 2}
Image__2023-02-22__14-00-25_label0_cls0,9,0,8,1,{'dirt': 1}
Image__2023-02-22__14-06-25_label3_cls0,9,0,8,1,{'dirt': 1}
Image__2024-04-15__12-14-22_label0_cls0,9,0,9,0,{}
Image__2023-03-15__13-30-17_label1_cls0,9,0,7,2,{'dirt': 2}
Image__2023-03-02__14-06-39_label2_cls0,9,0,7,2,{'dirt': 2}
Image__2023-03-02__13-34-43_label0_cls0,9,0,9,0,{}
Image__2023-02-28__14-09-41_label0_cls0,9,0,9,0,{}
Image__2023-05-24__12-42-21_label0_cls0,9,0,5,4,{'dirt': 4}
Image__2023-03-06__14-02-28_label1_cls0,9,0,9,0,{}
Image__2023-03-13__12-48-35_label0_cls0,9,0,8,1,{'dirt': 1}
Image__2023-02-27__14-06-42_label0_cls0,9,0,8,1,{'dirt': 1}
Image__2024-01-09__13-20-53_label0_cls0,9,0,9,0,{}
Image__2024-05-23__12-22-07_label0_cls0,9,0,9,0,{}
Image__2023-12-27__13-11-42_label0_cls0,9,0,9,0,{}
Image__2024-03-16__13-52-08_label0_cls0,9,0,9,0,{}
Image__2023-02-28__14-21-07_label0_cls0,9,0,9,0,{}
Image__2023-02-07__14-45-01_label0_cls0,9,0,8,1,{'dirt': 1}
Image__2023-02-22__13-42-05_label0_cls0,9,0,6,3,{'dirt': 3}
Image__2023-02-27__14-19-56_label0_cls0,9,0,8,1,{'dirt': 1}
Image__2023-03-01__13-49-53_label0_cls0,9,0,9,0,{}
Image__2023-03-02__14-09-03_label0_cls0,9,0,8,1,{'dirt': 1}
Image__2023-12-08__12-55-22_label2_cls0,9,0,9,0,{}
Image__2023-03-15__13-31-05_label1_cls0,9,0,7,2,{'dirt': 2}
Image__2024-04-06__12-40-06_label0_cls0,9,0,9,0,{}
Image__2023-02-22__13-34-22_label0_cls0,9,0,8,1,{'dirt': 1}
Image__2023-02-27__14-09-44_label0_cls0,9,0,8,1,{'dirt': 1}
Image__2023-03-13__13-06-13_label0_cls0,9,0,8,1,{'dirt': 1}
Image__2023-03-14__13-56-55_label1_cls0,9,0,1,8,{'dirt': 8}
Image__2024-04-03__13-30-51_label0_cls0,9,0,9,0,{}
Image__2023-02-28__14-25-32_label0_cls0,9,0,9,0,{}
Image__2023-03-08__10-23-45_label0_cls0,8,0,8,0,{}
Image__2024-03-19__12-37-08_label0_cls0,8,0,8,0,{}
Image__2023-03-15__14-10-23_label0_cls0,8,0,7,1,{'dirt': 1}
Image__2024-04-17__12-24-47_label0_cls0,8,0,8,0,{}
Image__2023-02-22__13-26-58_label2_cls0,8,0,6,2,{'dirt': 2}
Image__2023-12-13__12-24-49_label0_cls0,8,0,8,0,{}
Image__2023-03-09__14-38-51_label5_cls0,8,0,3,5,{'dirt': 5}
Image__2023-03-01__13-15-44_label0_cls0,8,0,8,0,{}
Image__2023-02-27__14-01-09_label0_cls0,8,0,7,1,{'dirt': 1}
Image__2023-03-15__14-26-08_label0_cls0,8,0,7,1,{'dirt': 1}
Image__2024-04-10__12-25-14_label0_cls0,8,0,8,0,{}
Image__2023-03-14__13-56-55_label2_cls0,8,0,0,8,{'dirt': 8}
Image__2024-04-11__12-11-12_label0_cls0,8,0,8,0,{}
Image__2024-05-14__12-20-51_label0_cls0,8,0,8,0,{}
Image__2023-03-09__14-43-53_label0_cls0,8,0,6,2,{'dirt': 2}
Image__2024-03-14__12-32-10_label0_cls0,8,0,8,0,{}
Image__2023-03-02__13-30-17_label1_cls0,8,0,8,0,{}
Image__2023-02-23__14-33-16_label4_cls0,8,0,5,3,{'dirt': 3}
Image__2023-03-14__14-16-12_label1_cls0,8,0,5,3,{'dirt': 3}
Image__2023-01-30__15-24-12_label0_cls0,8,0,7,1,{'dirt': 1}
Image__2023-02-28__14-02-53_label1_cls0,8,0,6,2,{'dirt': 2}
Image__2023-12-11__12-38-47_label1_cls0,8,0,8,0,{}
Image__2023-03-10__13-52-24_label0_cls0,8,0,6,2,{'dirt': 2}
Image__2023-03-14__14-13-31_label0_cls0,8,0,5,3,{'dirt': 3}
Image__2023-03-09__14-54-11_label0_cls0,8,0,5,3,{'dirt': 3}
Image__2023-03-16__13-50-32_label0_cls0,8,0,6,2,{'dirt': 2}
Image__2023-02-27__13-49-11_label2_cls0,8,0,7,1,{'dirt': 1}
Image__2023-03-09__14-38-51_label7_cls0,8,0,7,1,{'dirt': 1}
Image__2023-03-08__10-02-59_label3_cls0,8,0,5,3,{'dirt': 3}
Image__2024-02-26__12-42-07_label0_cls0,8,0,8,0,{}
Image__2023-03-14__14-07-02_label2_cls0,8,0,5,3,{'dirt': 3}
Image__2023-03-14__14-03-05_label1_cls0,8,0,5,3,{'dirt': 3}
Image__2023-02-22__13-58-11_label0_cls0,8,0,7,1,{'dirt': 1}
Image__2023-03-06__14-04-33_label1_cls0,8,0,8,0,{}
Image__2023-02-28__14-05-53_label1_cls0,8,0,8,0,{}
Image__2023-03-08__10-13-56_label1_cls0,8,0,8,0,{}
Image__2024-01-30__13-08-09_label1_cls0,8,0,8,0,{}
Image__2023-03-08__10-11-43_label0_cls0,8,0,8,0,{}
Image__2023-03-06__13-44-26_label1_cls0,8,0,8,0,{}
Image__2023-02-07__14-38-28_label3_cls0,8,0,7,1,{'dirt': 1}
Image__2023-02-07__14-38-28_label4_cls0,8,0,6,2,{'dirt': 2}
Image__2024-01-30__13-13-29_label0_cls0,8,0,8,0,{}
Image__2023-02-27__13-49-11_label3_cls0,8,0,7,1,{'dirt': 1}
Image__2023-03-09__14-38-51_label4_cls0,8,0,3,5,{'dirt': 5}
Image__2024-04-10__12-19-04_label0_cls0,8,0,8,0,{}
Image__2023-01-30__15-28-20_label0_cls0,8,0,7,1,{'dirt': 1}
Image__2023-02-27__13-49-11_label1_cls0,8,0,7,1,{'dirt': 1}
Image__2023-03-08__10-02-59_label0_cls0,8,0,5,3,{'dirt': 3}
Image__2024-04-17__12-28-33_label0_cls0,8,0,8,0,{}
Image__2023-03-01__13-35-14_label1_cls0,8,0,8,0,{}
Image__2023-03-14__13-56-55_label6_cls0,8,0,0,8,{'dirt': 8}
Image__2023-12-13__12-22-35_label0_cls0,8,0,8,0,{}
Image__2023-12-16__13-30-23_label12_cls0,8,0,8,0,{}
Image__2023-03-14__13-56-55_label5_cls0,8,0,0,8,{'dirt': 8}
Image__2023-03-13__13-28-06_label2_cls0,8,0,7,1,{'dirt': 1}
Image__2023-02-28__14-20-42_label0_cls0,8,0,8,0,{}
Image__2023-03-02__13-33-01_label0_cls0,7,0,7,0,{}
Image__2023-03-08__10-13-56_label0_cls0,7,0,7,0,{}
Image__2023-03-16__13-56-18_label0_cls0,7,0,5,2,{'dirt': 2}
Image__2023-03-15__14-09-37_label0_cls0,7,0,6,1,{'dirt': 1}
Image__2023-03-16__13-46-36_label1_cls0,7,0,0,7,{'dirt': 7}
Image__2023-03-08__10-23-18_label1_cls0,7,0,7,0,{}
Image__2023-03-01__13-31-19_label0_cls0,7,0,7,0,{}
Image__2023-03-08__10-22-50_label0_cls0,7,0,7,0,{}
Image__2023-02-28__14-00-27_label0_cls0,7,0,6,1,{'dirt': 1}
Image__2023-03-06__13-40-49_label5_cls0,7,0,7,0,{}
Image__2023-03-01__13-44-13_label0_cls0,7,0,7,0,{}
Image__2023-03-08__10-44-40_label0_cls0,7,0,7,0,{}
Image__2024-04-09__12-11-19_label0_cls0,7,0,7,0,{}
Image__2023-02-23__14-13-11_label0_cls0,7,0,5,2,{'dirt': 2}
Image__2023-03-06__13-57-47_label0_cls0,7,0,7,0,{}
Image__2023-02-23__14-24-16_label0_cls0,7,0,6,1,{'dirt': 1}
Image__2023-03-02__14-06-39_label1_cls0,7,0,4,3,{'dirt': 3}
Image__2023-12-13__12-31-46_label0_cls0,7,0,7,0,{}
Image__2023-03-10__12-58-14_label0_cls0,7,0,7,0,{}
Image__2024-02-28__12-30-54_label0_cls0,7,0,7,0,{}
Image__2023-02-23__14-23-27_label0_cls0,7,0,6,1,{'dirt': 1}
Image__2023-03-08__10-09-52_label2_cls0,7,0,4,3,{'dirt': 3}
Image__2023-03-01__13-51-59_label1_cls0,7,0,7,0,{}
Image__2024-05-16__12-26-03_label0_cls0,7,0,7,0,{}
Image__2023-03-10__13-34-41_label0_cls0,7,0,7,0,{}
Image__2024-03-26__13-25-55_label0_cls0,7,0,7,0,{}
Image__2023-03-06__13-49-47_label0_cls0,7,0,7,0,{}
Image__2023-02-27__14-22-20_label0_cls0,7,0,6,1,{'dirt': 1}
Image__2023-03-15__13-46-02_label3_cls0,7,0,0,7,{'dirt': 7}
Image__2023-10-30__13-19-42_label0_cls0,7,0,5,2,{'dirt': 2}
Image__2023-02-28__14-18-23_label0_cls0,7,0,7,0,{}
Image__2023-03-15__14-05-34_label2_cls0,7,0,4,3,{'dirt': 3}
Image__2024-05-14__12-15-09_label0_cls0,7,0,7,0,{}
Image__2023-03-14__14-26-22_label2_cls0,7,0,5,2,{'dirt': 2}
Image__2023-03-09__14-54-11_label1_cls0,7,0,3,4,{'dirt': 4}
Image__2023-03-08__10-37-54_label0_cls0,7,0,6,1,{'dirt': 1}
Image__2023-02-28__14-21-57_label0_cls0,7,0,7,0,{}
Image__2023-02-22__14-06-25_label2_cls0,7,0,6,1,{'dirt': 1}
Image__2023-03-02__13-59-32_label0_cls0,7,0,7,0,{}
Image__2023-03-01__13-19-29_label0_cls0,7,0,7,0,{}
Image__2023-12-11__12-38-47_label2_cls0,7,0,7,0,{}
Image__2023-03-02__14-10-32_label0_cls0,7,0,7,0,{}
Image__2023-03-10__13-18-31_label1_cls0,7,0,5,2,{'dirt': 2}
Image__2023-03-08__10-09-52_label0_cls0,7,0,4,3,{'dirt': 3}
Image__2023-03-14__14-14-02_label0_cls0,7,0,5,2,{'dirt': 2}
Image__2023-02-27__14-31-10_label0_cls0,7,0,6,1,{'dirt': 1}
Image__2023-03-15__14-28-06_label0_cls0,7,0,6,1,{'dirt': 1}
Image__2023-03-08__10-32-03_label1_cls0,7,0,7,0,{}
Image__2023-02-22__13-47-06_label2_cls0,7,0,6,1,{'dirt': 1}
Image__2023-05-24__12-39-56_label0_cls0,7,0,6,1,{'dirt': 1}
Image__2023-03-14__14-03-05_label0_cls0,7,0,4,3,{'dirt': 3}
Image__2024-04-11__12-11-41_label0_cls0,7,0,7,0,{}
Image__2023-03-15__13-59-52_label0_cls0,7,0,6,1,{'dirt': 1}
Image__2023-03-01__13-48-56_label0_cls0,7,0,7,0,{}
Image__2023-03-02__14-33-06_label0_cls0,7,0,7,0,{}
Image__2023-02-28__14-23-21_label0_cls0,7,0,7,0,{}
Image__2023-03-16__13-59-07_label1_cls0,7,0,5,2,{'dirt': 2}
Image__2023-02-27__13-50-16_label0_cls0,7,0,6,1,{'dirt': 1}
Image__2023-03-10__13-26-56_label5_cls0,7,0,7,0,{}
Image__2023-03-14__14-18-17_label0_cls0,7,0,6,1,{'dirt': 1}
Image__2023-01-30__15-25-04_label0_cls0,7,0,6,1,{'dirt': 1}
Image__2023-02-27__13-57-01_label0_cls0,7,0,6,1,{'dirt': 1}
Image__2024-05-14__12-18-00_label0_cls0,7,0,7,0,{}
Image__2023-03-13__13-31-06_label0_cls0,7,0,6,1,{'dirt': 1}
Image__2023-01-30__15-25-04_label1_cls0,7,0,6,1,{'dirt': 1}
Image__2024-04-09__12-17-14_label0_cls0,7,0,7,0,{}
Image__2023-03-10__13-30-23_label0_cls0,7,0,7,0,{}
Image__2023-03-16__14-01-05_label0_cls0,7,0,5,2,{'dirt': 2}
Image__2023-02-22__13-35-28_label0_cls0,7,0,6,1,{'dirt': 1}
Image__2024-01-09__13-21-27_label0_cls0,7,0,7,0,{}
Image__2024-03-23__12-26-49_label0_cls0,7,0,7,0,{}
Image__2023-03-08__10-05-37_label0_cls0,7,0,6,1,{'dirt': 1}
Image__2023-03-06__13-16-00_label2_cls0,6,0,6,0,{}
Image__2023-10-30__13-27-27_label0_cls0,6,0,6,0,{}
Image__2023-02-27__14-23-06_label0_cls0,6,0,5,1,{'dirt': 1}
Image__2023-03-06__13-21-35_label0_cls0,6,0,6,0,{}
Image__2023-02-28__13-52-33_label3_cls0,6,0,0,6,{'dirt': 6}
Image__2023-03-06__13-59-15_label0_cls0,6,0,6,0,{}
Image__2023-12-08__12-59-02_label0_cls0,6,0,6,0,{}
Image__2023-03-17__12-56-17_label4_cls0,6,0,0,6,{'dirt': 6}
Image__2023-03-02__13-51-11_label1_cls0,6,0,6,0,{}
Image__2024-02-21__12-34-48_label4_cls0,6,0,6,0,{}
Image__2023-03-15__14-30-11_label1_cls0,6,0,0,6,{'dirt': 6}
Image__2023-03-01__13-59-20_label0_cls0,6,0,6,0,{}
Image__2023-03-10__13-50-47_label0_cls0,6,0,5,1,{'dirt': 1}
Image__2023-03-14__14-13-31_label1_cls0,6,0,3,3,{'dirt': 3}
Image__2023-12-13__12-28-16_label1_cls0,6,0,6,0,{}
Image__2023-02-28__13-54-22_label2_cls0,6,0,2,4,{'dirt': 4}
Image__2023-03-15__14-30-11_label2_cls0,6,0,0,6,{'dirt': 6}
Image__2023-03-15__14-09-01_label2_cls0,6,0,1,5,{'dirt': 5}
Image__2024-05-17__12-17-49_label0_cls0,6,0,6,0,{}
Image__2023-03-08__10-09-52_label1_cls0,6,0,3,3,{'dirt': 3}
Image__2023-02-27__14-32-03_label0_cls0,6,0,5,1,{'dirt': 1}
Image__2023-03-08__10-24-13_label0_cls0,6,0,6,0,{}
Image__2023-03-14__14-02-26_label0_cls0,6,0,5,1,{'dirt': 1}
Image__2023-03-09__14-38-51_label3_cls0,6,0,1,5,{'dirt': 5}
Image__2023-03-17__13-04-20_label2_cls0,6,0,2,4,{'dirt': 4}
Image__2023-03-09__14-43-53_label1_cls0,6,0,4,2,{'dirt': 2}
Image__2023-02-22__14-06-25_label5_cls0,6,0,5,1,{'dirt': 1}
Image__2023-03-06__13-36-09_label0_cls0,6,0,6,0,{}
Image__2023-12-16__13-32-44_label0_cls0,6,0,6,0,{}
Image__2023-03-01__13-51-59_label0_cls0,6,0,6,0,{}
Image__2023-03-09__14-38-51_label2_cls0,6,0,1,5,{'dirt': 5}
Image__2024-03-19__12-32-29_label0_cls0,6,0,6,0,{}
Image__2023-03-15__14-05-34_label0_cls0,6,0,3,3,{'dirt': 3}
Image__2023-03-06__13-17-33_label0_cls0,6,0,6,0,{}
Image__2023-02-28__14-26-35_label1_cls0,6,0,5,1,{'dirt': 1}
Image__2023-03-17__13-04-20_label0_cls0,6,0,2,4,{'dirt': 4}
Image__2023-02-22__14-04-27_label0_cls0,6,0,5,1,{'dirt': 1}
Image__2023-05-24__12-54-45_label0_cls0,6,0,2,4,{'dirt': 4}
Image__2023-03-06__13-49-20_label0_cls0,6,0,6,0,{}
Image__2023-03-06__13-38-01_label0_cls0,6,0,6,0,{}
Image__2023-03-14__14-13-00_label0_cls0,6,0,5,1,{'dirt': 1}
Image__2023-03-10__13-00-49_label0_cls0,6,0,6,0,{}
Image__2023-01-30__15-32-26_label0_cls0,6,0,5,1,{'dirt': 1}
Image__2023-03-16__13-46-36_label0_cls0,6,0,3,3,{'dirt': 3}
Image__2023-03-06__13-44-26_label2_cls0,6,0,6,0,{}
Image__2023-03-02__13-32-14_label0_cls0,6,0,6,0,{}
Image__2023-12-26__12-52-59_label0_cls0,6,0,6,0,{}
Image__2023-02-22__13-51-50_label1_cls0,6,0,5,1,{'dirt': 1}
Image__2023-02-06__15-20-35_label0_cls0,6,0,3,3,{'dirt': 3}
Image__2023-03-01__13-42-20_label1_cls0,6,0,6,0,{}
Image__2024-04-10__12-20-08_label0_cls0,6,0,6,0,{}
Image__2023-02-23__14-26-32_label0_cls0,6,0,5,1,{'dirt': 1}
Image__2023-02-27__14-35-33_label0_cls0,6,0,5,1,{'dirt': 1}
Image__2023-02-27__14-02-38_label0_cls0,6,0,5,1,{'dirt': 1}
Image__2023-12-26__12-52-59_label1_cls0,6,0,6,0,{}
Image__2023-03-13__13-05-30_label0_cls0,6,0,4,2,{'dirt': 2}
Image__2023-01-30__15-34-41_label0_cls0,6,0,5,1,{'dirt': 1}
Image__2023-12-13__12-32-37_label0_cls0,6,0,6,0,{}
Image__2023-03-17__13-04-20_label3_cls0,6,0,1,5,{'dirt': 5}
Image__2023-03-15__14-09-01_label1_cls0,6,0,1,5,{'dirt': 5}
Image__2023-12-26__12-59-24_label0_cls0,6,0,6,0,{}
Image__2023-02-22__14-02-37_label0_cls0,6,0,5,1,{'dirt': 1}
Image__2024-01-29__13-08-34_label0_cls0,6,0,6,0,{}
Image__2023-03-01__13-35-14_label0_cls0,6,0,6,0,{}
Image__2023-02-28__13-52-33_label1_cls0,6,0,4,2,{'dirt': 2}
Image__2023-03-14__14-04-26_label0_cls0,6,0,4,2,{'dirt': 2}
Image__2024-04-19__13-23-29_label0_cls0,6,0,6,0,{}
Image__2023-03-06__13-23-12_label0_cls0,6,0,6,0,{}
Image__2024-01-23__13-06-31_label0_cls0,6,0,6,0,{}
Image__2023-02-27__14-13-40_label0_cls0,6,0,5,1,{'dirt': 1}
Image__2023-03-10__13-37-49_label0_cls0,6,0,5,1,{'dirt': 1}
Image__2024-01-29__13-07-50_label0_cls0,6,0,6,0,{}
Image__2023-02-22__14-02-07_label0_cls0,6,0,5,1,{'dirt': 1}
Image__2023-03-06__14-10-26_label0_cls0,6,0,6,0,{}
Image__2024-03-26__13-27-55_label0_cls0,6,0,6,0,{}
Image__2023-03-10__14-01-20_label0_cls0,6,0,5,1,{'dirt': 1}
Image__2023-03-13__12-44-17_label0_cls0,6,0,5,1,{'dirt': 1}
Image__2023-03-13__13-45-56_label0_cls0,6,0,5,1,{'dirt': 1}
Image__2024-01-22__12-03-26_label0_cls0,5,0,5,0,{}
Image__2023-03-15__14-30-11_label0_cls0,5,0,0,5,{'dirt': 5}
Image__2023-03-15__14-12-06_label0_cls0,5,0,4,1,{'dirt': 1}
Image__2023-02-22__13-52-56_label0_cls0,5,0,4,1,{'dirt': 1}
Image__2024-01-30__13-08-09_label0_cls0,5,0,5,0,{}
Image__2023-03-13__12-41-45_label0_cls0,5,0,4,1,{'dirt': 1}
Image__2023-03-13__12-35-53_label0_cls0,5,0,0,5,{'dirt': 5}
Image__2023-03-13__12-35-53_label4_cls0,5,0,0,5,{'dirt': 5}
Image__2023-12-16__13-30-23_label5_cls0,5,0,5,0,{}
Image__2023-02-06__15-20-35_label1_cls0,5,0,2,3,{'dirt': 3}
Image__2023-03-08__10-02-23_label0_cls0,5,0,4,1,{'dirt': 1}
Image__2023-03-15__13-28-18_label3_cls0,5,0,1,4,{'dirt': 4}
Image__2023-03-17__12-59-35_label0_cls0,5,0,1,4,{'dirt': 4}
Image__2023-03-15__13-52-56_label0_cls0,5,0,4,1,{'dirt': 1}
Image__2023-03-13__12-35-53_label1_cls0,5,0,0,5,{'dirt': 5}
Image__2023-12-13__12-32-37_label1_cls0,5,0,5,0,{}
Image__2023-03-17__12-56-17_label2_cls0,5,0,0,5,{'dirt': 5}
Image__2023-03-10__13-19-30_label0_cls0,5,0,4,1,{'dirt': 1}
Image__2023-03-10__13-39-06_label1_cls0,5,0,4,1,{'dirt': 1}
Image__2023-03-13__13-15-04_label1_cls0,5,0,3,2,{'dirt': 2}
Image__2023-03-15__14-09-01_label0_cls0,5,0,0,5,{'dirt': 5}
Image__2024-04-15__12-17-08_label1_cls0,5,0,5,0,{}
Image__2023-12-11__12-27-52_label1_cls0,5,0,5,0,{}
Image__2023-03-15__13-37-04_label0_cls0,5,0,4,1,{'dirt': 1}
Image__2023-03-13__12-36-41_label1_cls0,5,0,2,3,{'dirt': 3}
Image__2023-03-13__13-46-30_label0_cls0,5,0,4,1,{'dirt': 1}
Image__2023-02-01__15-26-56_label0_cls0,5,0,4,1,{'dirt': 1}
Image__2023-03-02__13-58-30_label0_cls0,5,0,5,0,{}
Image__2023-03-15__14-19-09_label0_cls0,5,0,4,1,{'dirt': 1}
Image__2023-03-01__13-15-44_label1_cls0,5,0,5,0,{}
Image__2023-03-10__14-02-21_label0_cls0,5,0,4,1,{'dirt': 1}
Image__2023-03-16__13-55-42_label0_cls0,5,0,3,2,{'dirt': 2}
Image__2023-02-23__14-09-09_label0_cls0,5,0,4,1,{'dirt': 1}
Image__2023-03-13__12-53-11_label0_cls0,5,0,4,1,{'dirt': 1}
Image__2023-03-08__10-31-41_label0_cls0,5,0,5,0,{}
Image__2024-05-14__12-12-27_label0_cls0,5,0,5,0,{}
Image__2023-03-16__13-59-07_label0_cls0,5,0,3,2,{'dirt': 2}
Image__2023-03-14__14-09-54_label0_cls0,5,0,3,2,{'dirt': 2}
Image__2023-02-01__15-23-58_label0_cls0,5,0,3,2,{'dirt': 2}
Image__2023-03-10__13-06-46_label0_cls0,5,0,5,0,{}
Image__2023-03-15__14-30-11_label4_cls0,5,0,0,5,{'dirt': 5}
Image__2023-02-28__13-52-33_label4_cls0,5,0,0,5,{'dirt': 5}
Image__2023-02-27__13-45-24_label0_cls0,5,0,4,1,{'dirt': 1}
Image__2024-04-11__12-12-54_label0_cls0,5,0,5,0,{}
Image__2023-02-28__13-50-18_label0_cls0,5,0,4,1,{'dirt': 1}
Image__2023-03-16__13-46-36_label3_cls0,5,0,0,5,{'dirt': 5}
Image__2023-03-09__14-31-40_label0_cls0,5,0,5,0,{}
Image__2023-05-24__12-30-36_label0_cls0,5,0,1,4,{'dirt': 4}
Image__2023-03-06__13-49-47_label1_cls0,5,0,5,0,{}
Image__2024-03-18__12-27-01_label0_cls0,5,0,5,0,{}
Image__2023-03-15__14-30-11_label3_cls0,5,0,0,5,{'dirt': 5}
Image__2023-02-06__15-20-35_label2_cls0,5,0,2,3,{'dirt': 3}
Image__2023-02-28__13-57-32_label0_cls0,5,0,4,1,{'dirt': 1}
Image__2023-02-22__14-05-21_label0_cls0,5,0,4,1,{'dirt': 1}
Image__2023-03-06__13-19-32_label0_cls0,5,0,5,0,{}
Image__2023-03-01__13-49-53_label1_cls0,5,0,5,0,{}
Image__2023-02-28__14-30-25_label0_cls0,5,0,2,3,{'dirt': 3}
Image__2023-12-16__13-30-23_label9_cls0,5,0,5,0,{}
Image__2023-03-15__14-09-01_label4_cls0,5,0,0,5,{'dirt': 5}
Image__2023-03-13__12-36-41_label3_cls0,5,0,2,3,{'dirt': 3}
Image__2023-02-13__14-29-31_label0_cls0,5,0,4,1,{'dirt': 1}
Image__2023-03-13__12-55-21_label0_cls0,5,0,4,1,{'dirt': 1}
Image__2023-03-13__13-15-04_label0_cls0,5,0,3,2,{'dirt': 2}
Image__2023-03-15__13-45-17_label0_cls0,5,0,4,1,{'dirt': 1}
Image__2024-04-25__13-21-10_label0_cls0,5,0,5,0,{}
Image__2024-01-23__13-08-38_label0_cls0,5,0,5,0,{}
Image__2023-03-13__12-35-53_label3_cls0,5,0,0,5,{'dirt': 5}
Image__2023-03-06__13-24-49_label0_cls0,5,0,5,0,{}
Image__2023-02-28__14-06-27_label0_cls0,5,0,5,0,{}
Image__2023-03-17__12-56-17_label0_cls0,5,0,0,5,{'dirt': 5}
Image__2023-03-13__12-35-53_label2_cls0,5,0,0,5,{'dirt': 5}
Image__2024-05-21__12-18-33_label0_cls0,5,0,5,0,{}
Image__2023-03-10__13-18-31_label0_cls0,5,0,3,2,{'dirt': 2}
Image__2023-03-15__13-31-05_label0_cls0,5,0,3,2,{'dirt': 2}
Image__2024-01-23__13-07-43_label0_cls0,5,0,5,0,{}
Image__2023-02-22__13-43-37_label0_cls0,5,0,4,1,{'dirt': 1}
Image__2023-12-13__12-35-32_label0_cls0,5,0,5,0,{}
Image__2024-01-22__12-11-45_label0_cls0,5,0,5,0,{}
Image__2023-03-09__14-52-44_label1_cls0,5,0,4,1,{'dirt': 1}
Image__2023-03-09__14-52-44_label0_cls0,5,0,4,1,{'dirt': 1}
Image__2023-03-08__10-07-30_label0_cls0,5,0,3,2,{'dirt': 2}
Image__2023-03-10__13-48-13_label1_cls0,5,0,2,3,{'dirt': 3}
Image__2023-03-17__13-06-24_label1_cls0,5,0,3,2,{'dirt': 2}
Image__2023-03-15__14-09-01_label3_cls0,5,0,0,5,{'dirt': 5}
Image__2023-05-24__12-38-21_label0_cls0,5,0,4,1,{'dirt': 1}
Image__2023-03-17__12-51-13_label0_cls0,5,0,4,1,{'dirt': 1}
Image__2024-03-23__12-40-20_label0_cls0,5,0,5,0,{}
Image__2024-01-27__12-35-21_label0_cls0,5,0,5,0,{}
Image__2023-03-08__10-34-57_label1_cls0,5,0,5,0,{}
Image__2023-12-16__13-42-01_label0_cls0,4,0,4,0,{}
Image__2023-03-01__13-58-04_label0_cls0,4,0,4,0,{}
Image__2023-02-27__13-47-10_label1_cls0,4,0,2,2,{'dirt': 2}
Image__2023-03-14__14-06-05_label0_cls0,4,0,0,4,{'dirt': 4}
Image__2023-12-16__13-30-23_label11_cls0,4,0,4,0,{}
Image__2024-04-16__12-12-57_label0_cls0,4,0,4,0,{}
Image__2023-03-15__13-55-06_label1_cls0,4,0,2,2,{'dirt': 2}
Image__2023-03-01__14-07-09_label1_cls0,4,0,4,0,{}
Image__2023-02-06__15-20-35_label4_cls0,4,0,1,3,{'dirt': 3}
Image__2023-03-06__13-25-39_label0_cls0,4,0,4,0,{}
Image__2023-03-01__13-52-27_label0_cls0,4,0,4,0,{}
Image__2023-02-24__10-37-32_label0_cls0,4,0,3,1,{'dirt': 1}
Image__2024-04-09__12-20-20_label0_cls0,4,0,4,0,{}
Image__2023-03-09__14-42-25_label0_cls0,4,0,3,1,{'dirt': 1}
Image__2023-03-14__14-04-54_label0_cls0,4,0,3,1,{'dirt': 1}
Image__2023-02-22__14-03-27_label0_cls0,4,0,3,1,{'dirt': 1}
Image__2024-04-09__12-16-34_label0_cls0,4,0,4,0,{}
Image__2023-03-13__13-16-52_label0_cls0,4,0,2,2,{'dirt': 2}
Image__2023-03-15__13-53-45_label0_cls0,4,0,3,1,{'dirt': 1}
Image__2024-05-16__12-17-49_label0_cls0,4,0,4,0,{}
Image__2023-03-15__13-28-18_label1_cls0,4,0,0,4,{'dirt': 4}
Image__2023-03-13__12-44-54_label0_cls0,4,0,2,2,{'dirt': 2}
Image__2023-03-17__12-48-15_label0_cls0,4,0,2,2,{'dirt': 2}
Image__2023-03-17__12-56-17_label3_cls0,4,0,0,4,{'dirt': 4}
Image__2023-03-15__14-04-20_label0_cls0,4,0,2,2,{'dirt': 2}
Image__2023-03-14__14-03-52_label0_cls0,4,0,2,2,{'dirt': 2}
Image__2023-03-08__10-35-59_label2_cls0,4,0,3,1,{'dirt': 1}
Image__2023-03-13__13-30-16_label4_cls0,4,0,0,4,{'dirt': 4}
Image__2023-02-28__13-54-22_label3_cls0,4,0,0,4,{'dirt': 4}
Image__2023-02-27__14-06-15_label2_cls0,4,0,3,1,{'dirt': 1}
Image__2023-03-15__14-07-27_label0_cls0,4,0,0,4,{'dirt': 4}
Image__2023-03-09__14-53-46_label0_cls0,4,0,3,1,{'dirt': 1}
Image__2023-03-14__14-09-19_label1_cls0,4,0,0,4,{'dirt': 4}
Image__2024-04-06__12-41-14_label0_cls0,4,0,4,0,{}
Image__2023-03-15__13-46-02_label0_cls0,4,0,0,4,{'dirt': 4}
Image__2023-02-07__14-38-28_label6_cls0,4,0,2,2,{'dirt': 2}
Image__2023-03-15__13-49-27_label0_cls0,4,0,0,4,{'dirt': 4}
Image__2023-03-14__14-09-19_label3_cls0,4,0,0,4,{'dirt': 4}
Image__2023-03-02__13-37-01_label0_cls0,4,0,4,0,{}
Image__2024-01-22__12-11-11_label0_cls0,4,0,4,0,{}
Image__2023-02-27__14-33-14_label0_cls0,4,0,2,2,{'dirt': 2}
Image__2023-03-15__13-46-02_label5_cls0,4,0,0,4,{'dirt': 4}
Image__2024-03-18__12-29-06_label0_cls0,4,0,4,0,{}
Image__2023-12-16__13-42-01_label3_cls0,4,0,4,0,{}
Image__2023-03-16__13-49-51_label0_cls0,4,0,3,1,{'dirt': 1}
Image__2023-03-15__13-49-27_label2_cls0,4,0,0,4,{'dirt': 4}
Image__2023-02-22__14-06-25_label1_cls0,4,0,3,1,{'dirt': 1}
Image__2023-02-01__15-22-01_label0_cls0,4,0,3,1,{'dirt': 1}
Image__2023-02-28__14-04-28_label0_cls0,4,0,3,1,{'dirt': 1}
Image__2023-03-15__14-05-34_label1_cls0,4,0,1,3,{'dirt': 3}
Image__2023-02-24__10-35-26_label0_cls0,4,0,3,1,{'dirt': 1}
Image__2023-03-15__13-55-06_label0_cls0,4,0,2,2,{'dirt': 2}
Image__2023-03-17__13-16-19_label0_cls0,4,0,0,4,{'dirt': 4}
Image__2023-02-27__14-05-22_label0_cls0,4,0,3,1,{'dirt': 1}
Image__2024-02-21__12-34-48_label1_cls0,4,0,4,0,{}
Image__2023-03-01__13-33-10_label0_cls0,4,0,4,0,{}
Image__2023-03-15__13-28-18_label2_cls0,4,0,0,4,{'dirt': 4}
Image__2023-02-27__14-03-45_label0_cls0,4,0,3,1,{'dirt': 1}
Image__2023-03-17__13-16-19_label1_cls0,4,0,0,4,{'dirt': 4}
Image__2023-03-15__14-10-55_label0_cls0,4,0,3,1,{'dirt': 1}
Image__2023-03-15__13-31-51_label0_cls0,4,0,3,1,{'dirt': 1}
Image__2023-03-06__13-23-42_label0_cls0,4,0,4,0,{}
Image__2023-03-17__12-48-50_label0_cls0,4,0,2,2,{'dirt': 2}
Image__2023-03-01__14-07-09_label0_cls0,4,0,4,0,{}
Image__2023-02-27__14-25-20_label0_cls0,4,0,3,1,{'dirt': 1}
Image__2023-03-14__14-09-54_label1_cls0,4,0,2,2,{'dirt': 2}
Image__2024-03-16__13-43-31_label0_cls0,4,0,4,0,{}
Image__2023-03-15__13-36-24_label0_cls0,4,0,3,1,{'dirt': 1}
Image__2023-02-06__15-20-35_label3_cls0,4,0,1,3,{'dirt': 3}
Image__2023-02-27__13-59-25_label0_cls0,4,0,3,1,{'dirt': 1}
Image__2023-02-27__14-14-28_label0_cls0,4,0,3,1,{'dirt': 1}
Image__2023-02-28__13-58-50_label0_cls0,4,0,2,2,{'dirt': 2}
Image__2023-03-17__13-28-02_label0_cls0,4,0,3,1,{'dirt': 1}
Image__2023-02-28__13-54-22_label0_cls0,4,0,0,4,{'dirt': 4}
Image__2023-02-22__13-38-53_label0_cls0,4,0,3,1,{'dirt': 1}
Image__2023-03-15__13-59-12_label1_cls0,4,0,2,2,{'dirt': 2}
Image__2023-03-10__13-26-56_label3_cls0,4,0,4,0,{}
Image__2024-03-16__13-46-55_label0_cls0,4,0,4,0,{}
Image__2024-02-26__12-45-59_label0_cls0,4,0,4,0,{}
Image__2024-02-28__12-32-59_label0_cls0,4,0,4,0,{}
Image__2023-03-15__13-49-27_label3_cls0,4,0,0,4,{'dirt': 4}
Image__2023-03-02__13-59-32_label1_cls0,4,0,4,0,{}
Image__2023-02-28__14-19-45_label2_cls0,4,0,4,0,{}
Image__2023-03-10__13-54-01_label1_cls0,4,0,1,3,{'dirt': 3}
Image__2023-03-08__10-36-56_label0_cls0,4,0,0,4,{'dirt': 4}
Image__2024-03-19__12-26-35_label0_cls0,4,0,4,0,{}
Image__2023-03-15__13-49-27_label1_cls0,4,0,0,4,{'dirt': 4}
Image__2023-03-13__12-47-26_label0_cls0,4,0,3,1,{'dirt': 1}
Image__2023-03-02__13-58-30_label1_cls0,4,0,4,0,{}
Image__2023-10-30__13-21-19_label0_cls0,4,0,0,4,{'dirt': 4}
Image__2023-03-01__14-07-09_label6_cls0,4,0,4,0,{}
Image__2023-02-07__14-38-28_label7_cls0,4,0,2,2,{'dirt': 2}
Image__2023-03-02__14-29-00_label0_cls0,4,0,4,0,{}
Image__2023-03-10__13-25-49_label0_cls0,4,0,3,1,{'dirt': 1}
Image__2024-03-16__13-47-29_label0_cls0,4,0,4,0,{}
Image__2023-03-01__14-07-09_label4_cls0,4,0,4,0,{}
Image__2024-05-17__12-25-46_label0_cls0,4,0,4,0,{}
Image__2024-05-16__12-20-13_label0_cls0,4,0,4,0,{}
Image__2023-03-13__13-07-35_label1_cls0,4,0,2,2,{'dirt': 2}
Image__2023-03-15__13-59-12_label0_cls0,4,0,2,2,{'dirt': 2}
Image__2023-03-01__14-07-09_label2_cls0,4,0,4,0,{}
Image__2023-03-10__13-10-12_label0_cls0,4,0,4,0,{}
Image__2023-03-13__13-00-36_label0_cls0,4,0,2,2,{'dirt': 2}
Image__2024-04-16__12-15-53_label0_cls0,4,0,4,0,{}
Image__2024-05-16__12-28-15_label0_cls0,4,0,4,0,{}
Image__2023-03-17__12-56-17_label1_cls0,4,0,0,4,{'dirt': 4}
Image__2023-02-28__13-57-32_label1_cls0,4,0,3,1,{'dirt': 1}
Image__2023-02-28__14-02-53_label0_cls0,4,0,2,2,{'dirt': 2}
Image__2024-02-26__12-44-48_label0_cls0,4,0,4,0,{}
Image__2024-04-10__12-27-00_label0_cls0,4,0,4,0,{}
Image__2023-10-30__13-24-33_label0_cls0,4,0,4,0,{}
Image__2023-03-14__14-06-05_label3_cls0,4,0,1,3,{'dirt': 3}
Image__2023-03-01__13-24-18_label1_cls0,4,0,4,0,{}
Image__2023-02-28__13-54-22_label1_cls0,4,0,0,4,{'dirt': 4}
Image__2024-04-17__12-29-33_label0_cls0,4,0,4,0,{}
Image__2023-03-17__12-51-53_label0_cls0,4,0,3,1,{'dirt': 1}
Image__2023-03-14__14-09-19_label2_cls0,4,0,0,4,{'dirt': 4}
Image__2023-03-15__13-28-18_label0_cls0,4,0,0,4,{'dirt': 4}
Image__2023-03-16__14-00-03_label0_cls0,4,0,2,2,{'dirt': 2}
Image__2023-03-13__13-23-09_label0_cls0,4,0,0,4,{'dirt': 4}
Image__2023-03-13__13-33-54_label0_cls0,4,0,3,1,{'dirt': 1}
Image__2023-03-17__12-58-44_label0_cls0,4,0,3,1,{'dirt': 1}
Image__2023-03-06__13-51-32_label0_cls0,4,0,4,0,{}
Image__2023-03-02__13-52-17_label0_cls0,4,0,4,0,{}
Image__2023-12-13__12-32-37_label2_cls0,4,0,4,0,{}
Image__2024-03-26__13-27-22_label0_cls0,4,0,4,0,{}
Image__2023-02-28__13-54-51_label1_cls0,4,0,0,4,{'dirt': 4}
Image__2023-03-15__14-07-27_label1_cls0,4,0,0,4,{'dirt': 4}
Image__2024-01-23__13-13-37_label0_cls0,3,0,3,0,{}
Image__2023-03-01__13-39-08_label0_cls0,3,0,3,0,{}
Image__2023-03-13__13-37-21_label0_cls0,3,0,0,3,{'dirt': 3}
Image__2024-03-02__13-14-23_label0_cls0,3,0,3,0,{}
Image__2024-04-10__12-14-56_label0_cls0,3,0,3,0,{}
Image__2023-02-23__14-32-08_label0_cls0,3,0,2,1,{'dirt': 1}
Image__2023-02-22__13-56-26_label3_cls0,3,0,2,1,{'dirt': 1}
Image__2023-03-01__14-00-49_label0_cls0,3,0,3,0,{}
Image__2023-02-28__14-18-48_label0_cls0,3,0,3,0,{}
Image__2023-03-10__13-55-14_label0_cls0,3,0,2,1,{'dirt': 1}
Image__2023-03-14__13-59-40_label3_cls0,3,0,0,3,{'dirt': 3}
Image__2023-03-13__12-36-41_label2_cls0,3,0,0,3,{'dirt': 3}
Image__2024-05-18__13-21-15_label0_cls0,3,0,3,0,{}
Image__2023-03-14__13-59-40_label2_cls0,3,0,0,3,{'dirt': 3}
Image__2023-02-23__14-19-06_label0_cls0,3,0,2,1,{'dirt': 1}
Image__2023-03-01__13-35-34_label0_cls0,3,0,3,0,{}
Image__2024-03-28__13-30-12_label0_cls0,3,0,3,0,{}
Image__2024-04-06__12-37-26_label1_cls0,3,0,3,0,{}
Image__2023-03-13__13-13-46_label0_cls0,3,0,2,1,{'dirt': 1}
Image__2023-03-14__14-09-19_label0_cls0,3,0,0,3,{'dirt': 3}
Image__2023-03-08__10-18-42_label0_cls0,3,0,3,0,{}
Image__2023-02-07__14-38-28_label8_cls0,3,0,1,2,{'dirt': 2}
Image__2023-03-10__13-35-58_label0_cls0,3,0,2,1,{'dirt': 1}
Image__2023-03-08__10-39-18_label0_cls0,3,0,2,1,{'dirt': 1}
Image__2023-03-01__13-24-18_label0_cls0,3,0,3,0,{}
Image__2023-03-10__12-51-31_label1_cls0,3,0,3,0,{}
Image__2023-02-27__14-11-51_label0_cls0,3,0,2,1,{'dirt': 1}
Image__2023-03-14__13-59-40_label0_cls0,3,0,0,3,{'dirt': 3}
Image__2023-03-13__13-30-16_label2_cls0,3,0,0,3,{'dirt': 3}
Image__2023-02-28__14-03-52_label0_cls0,3,0,2,1,{'dirt': 1}
Image__2023-03-10__13-20-06_label0_cls0,3,0,2,1,{'dirt': 1}
Image__2023-03-14__14-23-56_label0_cls0,3,0,2,1,{'dirt': 1}
Image__2023-03-13__13-19-19_label0_cls0,3,0,2,1,{'dirt': 1}
Image__2023-05-24__13-00-57_label0_cls0,3,0,2,1,{'dirt': 1}
Image__2023-03-17__13-09-57_label2_cls0,3,0,0,3,{'dirt': 3}
Image__2023-03-16__13-39-24_label1_cls0,3,0,0,3,{'dirt': 3}
Image__2024-03-23__12-25-59_label0_cls0,3,0,3,0,{}
Image__2023-02-22__13-40-59_label1_cls0,3,0,0,3,{'dirt': 3}
Image__2023-02-27__14-06-42_label1_cls0,3,0,2,1,{'dirt': 1}
Image__2023-03-13__13-16-52_label1_cls0,3,0,1,2,{'dirt': 2}
Image__2024-04-06__12-37-53_label0_cls0,3,0,3,0,{}
Image__2023-03-14__14-00-51_label0_cls0,3,0,0,3,{'dirt': 3}
Image__2023-03-16__13-46-36_label2_cls0,3,0,2,1,{'dirt': 1}
Image__2023-03-10__13-07-28_label0_cls0,3,0,3,0,{}
Image__2024-01-09__13-21-27_label1_cls0,3,0,3,0,{}
Image__2023-03-02__13-53-17_label4_cls0,3,0,3,0,{}
Image__2023-03-08__10-10-46_label2_cls0,3,0,0,3,{'dirt': 3}
Image__2023-03-17__12-49-58_label0_cls0,3,0,1,2,{'dirt': 2}
Image__2023-03-10__13-54-01_label2_cls0,3,0,0,3,{'dirt': 3}
Image__2023-03-17__13-09-57_label1_cls0,3,0,0,3,{'dirt': 3}
Image__2024-02-21__12-34-48_label2_cls0,3,0,3,0,{}
Image__2023-03-13__12-59-54_label0_cls0,3,0,2,1,{'dirt': 1}
Image__2024-04-06__12-42-57_label0_cls0,3,0,3,0,{}
Image__2023-03-06__13-47-31_label0_cls0,3,0,3,0,{}
Image__2023-03-14__14-00-51_label2_cls0,3,0,0,3,{'dirt': 3}
Image__2023-03-02__13-54-55_label0_cls0,3,0,3,0,{}
Image__2024-04-11__12-27-16_label0_cls0,3,0,3,0,{}
Image__2023-02-22__13-56-26_label5_cls0,3,0,2,1,{'dirt': 1}
Image__2023-01-30__15-29-45_label0_cls0,3,0,2,1,{'dirt': 1}
Image__2023-05-24__12-40-55_label0_cls0,3,0,2,1,{'dirt': 1}
Image__2023-03-10__13-29-47_label0_cls0,3,0,3,0,{}
Image__2023-03-02__13-55-49_label1_cls0,3,0,3,0,{}
Image__2023-03-08__10-18-09_label0_cls0,3,0,3,0,{}
Image__2023-03-06__14-09-09_label1_cls0,3,0,3,0,{}
Image__2023-02-23__14-23-27_label1_cls0,3,0,2,1,{'dirt': 1}
Image__2023-03-06__13-27-29_label1_cls0,3,0,3,0,{}
Image__2023-02-28__13-48-31_label0_cls0,3,0,2,1,{'dirt': 1}
Image__2023-03-08__10-08-58_label0_cls0,3,0,2,1,{'dirt': 1}
Image__2024-04-19__13-15-29_label0_cls0,3,0,3,0,{}
Image__2024-02-28__12-25-04_label0_cls0,3,0,3,0,{}
Image__2023-03-13__13-23-09_label1_cls0,3,0,0,3,{'dirt': 3}
Image__2023-03-06__13-38-55_label5_cls0,3,0,3,0,{}
Image__2023-02-24__10-40-59_label0_cls0,3,0,1,2,{'dirt': 2}
Image__2023-03-06__13-38-55_label6_cls0,3,0,3,0,{}
Image__2023-03-01__13-55-20_label0_cls0,3,0,3,0,{}
Image__2023-01-30__15-26-52_label0_cls0,3,0,2,1,{'dirt': 1}
Image__2023-02-02__13-50-51_label0_cls0,3,0,2,1,{'dirt': 1}
Image__2023-03-15__13-41-39_label0_cls0,3,0,2,1,{'dirt': 1}
Image__2023-03-01__14-07-09_label5_cls0,3,0,3,0,{}
Image__2023-02-28__14-10-10_label0_cls0,3,0,3,0,{}
Image__2023-03-10__13-26-56_label6_cls0,3,0,3,0,{}
Image__2023-12-08__12-57-29_label0_cls0,3,0,3,0,{}
Image__2023-03-01__13-19-53_label0_cls0,3,0,3,0,{}
Image__2023-03-17__13-05-47_label0_cls0,3,0,0,3,{'dirt': 3}
Image__2023-03-16__13-48-14_label0_cls0,3,0,2,1,{'dirt': 1}
Image__2023-03-08__10-05-13_label0_cls0,3,0,2,1,{'dirt': 1}
Image__2024-03-23__12-24-58_label0_cls0,3,0,3,0,{}
Image__2023-03-09__14-34-04_label0_cls0,3,0,3,0,{}
Image__2023-02-28__13-54-51_label0_cls0,3,0,0,3,{'dirt': 3}
Image__2023-03-13__13-37-21_label1_cls0,3,0,0,3,{'dirt': 3}
Image__2023-03-13__13-30-16_label3_cls0,3,0,0,3,{'dirt': 3}
Image__2023-12-13__12-28-16_label0_cls0,3,0,3,0,{}
Image__2023-03-17__13-13-04_label0_cls0,3,0,2,1,{'dirt': 1}
Image__2024-01-29__13-10-46_label0_cls0,3,0,3,0,{}
Image__2023-02-28__14-12-41_label0_cls0,3,0,3,0,{}
Image__2023-05-24__12-31-52_label0_cls0,3,0,1,2,{'dirt': 2}
Image__2023-03-13__13-33-26_label0_cls0,3,0,2,1,{'dirt': 1}
Image__2023-03-10__13-35-58_label1_cls0,3,0,2,1,{'dirt': 1}
Image__2023-03-01__13-27-47_label5_cls0,3,0,3,0,{}
Image__2024-01-29__13-12-22_label0_cls0,3,0,3,0,{}
Image__2023-03-17__13-12-16_label0_cls0,3,0,2,1,{'dirt': 1}
Image__2023-03-08__10-03-40_label0_cls0,3,0,2,1,{'dirt': 1}
Image__2023-03-13__13-30-16_label0_cls0,3,0,0,3,{'dirt': 3}
Image__2023-03-13__13-44-11_label0_cls0,3,0,2,1,{'dirt': 1}
Image__2023-03-06__13-42-44_label0_cls0,3,0,3,0,{}
Image__2023-02-28__14-05-00_label0_cls0,3,0,3,0,{}
Image__2023-02-24__10-29-28_label1_cls0,3,0,2,1,{'dirt': 1}
Image__2023-12-08__12-59-02_label1_cls0,3,0,3,0,{}
Image__2023-03-08__10-00-18_label0_cls0,3,0,3,0,{}
Image__2024-04-16__12-18-11_label0_cls0,3,0,3,0,{}
Image__2023-03-13__13-43-35_label0_cls0,3,0,2,1,{'dirt': 1}
Image__2023-02-24__10-33-12_label0_cls0,3,0,2,1,{'dirt': 1}
Image__2023-02-24__10-43-28_label0_cls0,3,0,2,1,{'dirt': 1}
Image__2023-03-17__13-09-57_label0_cls0,3,0,0,3,{'dirt': 3}
Image__2023-03-15__13-44-34_label0_cls0,3,0,2,1,{'dirt': 1}
Image__2023-03-13__13-07-35_label2_cls0,3,0,0,3,{'dirt': 3}
Image__2023-02-22__13-56-26_label2_cls0,3,0,2,1,{'dirt': 1}
Image__2023-02-27__14-04-58_label0_cls0,3,0,1,2,{'dirt': 2}
Image__2023-03-13__13-30-16_label1_cls0,3,0,0,3,{'dirt': 3}
Image__2023-02-24__10-43-28_label2_cls0,3,0,2,1,{'dirt': 1}
Image__2023-02-27__14-03-07_label0_cls0,3,0,2,1,{'dirt': 1}
Image__2023-03-16__13-40-32_label0_cls0,3,0,2,1,{'dirt': 1}
Image__2023-05-24__12-42-21_label1_cls0,3,0,0,3,{'dirt': 3}
Image__2023-03-01__13-27-47_label2_cls0,3,0,3,0,{}
Image__2023-03-01__13-42-20_label0_cls0,3,0,3,0,{}
Image__2023-03-01__13-39-08_label1_cls0,3,0,3,0,{}
Image__2023-03-02__13-54-04_label0_cls0,3,0,3,0,{}
Image__2023-02-28__14-02-16_label0_cls0,3,0,1,2,{'dirt': 2}
Image__2023-02-28__13-52-33_label2_cls0,3,0,2,1,{'dirt': 1}
Image__2023-03-16__13-43-53_label0_cls0,3,0,2,1,{'dirt': 1}
Image__2023-03-14__14-00-51_label1_cls0,3,0,0,3,{'dirt': 3}
Image__2023-03-14__14-06-05_label4_cls0,3,0,2,1,{'dirt': 1}
Image__2023-03-08__10-10-46_label3_cls0,3,0,0,3,{'dirt': 3}
Image__2023-03-16__13-53-05_label0_cls0,3,0,2,1,{'dirt': 1}
Image__2023-03-14__13-59-40_label1_cls0,3,0,0,3,{'dirt': 3}
Image__2023-03-10__13-54-01_label0_cls0,3,0,0,3,{'dirt': 3}
Image__2023-03-13__13-37-21_label2_cls0,3,0,0,3,{'dirt': 3}
Image__2023-03-06__13-35-45_label0_cls0,3,0,3,0,{}
Image__2023-03-01__13-14-26_label0_cls0,3,0,2,1,{'dirt': 1}
Image__2023-03-16__13-52-00_label0_cls0,3,0,2,1,{'dirt': 1}
Image__2024-03-18__12-30-40_label0_cls0,3,0,3,0,{}
Image__2023-02-22__13-56-26_label4_cls0,3,0,2,1,{'dirt': 1}
Image__2023-02-22__13-56-26_label0_cls0,3,0,2,1,{'dirt': 1}
Image__2023-02-22__14-06-55_label1_cls0,2,0,0,2,{'dirt': 2}
Image__2023-03-13__12-51-44_label1_cls0,2,0,0,2,{'dirt': 2}
Image__2023-03-15__13-42-45_label1_cls0,2,0,0,2,{'dirt': 2}
Image__2023-03-15__14-02-34_label0_cls0,2,0,0,2,{'dirt': 2}
Image__2023-03-01__13-53-52_label0_cls0,2,0,2,0,{}
Image__2023-02-07__14-38-28_label9_cls0,2,0,0,2,{'dirt': 2}
Image__2023-03-13__13-28-54_label0_cls0,2,0,1,1,{'dirt': 1}
Image__2023-02-22__14-07-50_label0_cls0,2,0,0,2,{'dirt': 2}
Image__2023-02-23__14-10-48_label0_cls0,2,0,1,1,{'dirt': 1}
Image__2023-03-15__13-33-41_label0_cls0,2,0,0,2,{'dirt': 2}
Image__2023-03-13__13-28-06_label1_cls0,2,0,0,2,{'dirt': 2}
Image__2023-03-16__13-42-23_label0_cls0,2,0,0,2,{'dirt': 2}
Image__2024-03-23__12-33-54_label0_cls0,2,0,2,0,{}
Image__2023-03-01__13-25-31_label0_cls0,2,0,2,0,{}
Image__2023-03-17__13-21-17_label1_cls0,2,0,0,2,{'dirt': 2}
Image__2023-03-17__12-55-40_label1_cls0,2,0,0,2,{'dirt': 2}
Image__2023-03-06__13-32-45_label0_cls0,2,0,2,0,{}
Image__2023-03-17__13-06-24_label0_cls0,2,0,0,2,{'dirt': 2}
Image__2023-12-27__13-12-59_label1_cls0,2,0,2,0,{}
Image__2023-02-22__14-06-55_label5_cls0,2,0,0,2,{'dirt': 2}
Image__2023-12-16__13-42-01_label2_cls0,2,0,2,0,{}
Image__2023-03-08__10-07-08_label1_cls0,2,0,0,2,{'dirt': 2}
Image__2023-03-06__13-40-49_label3_cls0,2,0,2,0,{}
Image__2023-03-13__12-51-44_label0_cls0,2,0,0,2,{'dirt': 2}
Image__2023-03-14__14-22-59_label1_cls0,2,0,0,2,{'dirt': 2}
Image__2023-02-28__14-11-51_label1_cls0,2,0,2,0,{}
Image__2023-03-01__13-24-40_label0_cls0,2,0,2,0,{}
Image__2023-03-02__14-00-07_label2_cls0,2,0,0,2,{'dirt': 2}
Image__2023-03-01__14-00-12_label0_cls0,2,0,2,0,{}
Image__2023-02-07__14-43-09_label0_cls0,2,0,1,1,{'dirt': 1}
Image__2023-02-28__13-52-56_label0_cls0,2,0,1,1,{'dirt': 1}
Image__2023-03-17__13-26-50_label0_cls0,2,0,0,2,{'dirt': 2}
Image__2023-03-15__13-33-41_label1_cls0,2,0,0,2,{'dirt': 2}
Image__2024-02-28__12-24-19_label0_cls0,2,0,2,0,{}
Image__2023-03-01__13-17-37_label0_cls0,2,0,2,0,{}
Image__2023-02-22__14-07-50_label1_cls0,2,0,0,2,{'dirt': 2}
Image__2023-02-06__15-20-35_label5_cls0,2,0,0,2,{'dirt': 2}
Image__2023-02-23__14-11-48_label1_cls0,2,0,0,2,{'dirt': 2}
Image__2023-03-10__13-40-26_label1_cls0,2,0,0,2,{'dirt': 2}
Image__2023-03-17__13-27-30_label0_cls0,2,0,0,2,{'dirt': 2}
Image__2023-03-08__10-08-30_label0_cls0,2,0,0,2,{'dirt': 2}
Image__2023-02-27__14-40-52_label0_cls0,2,0,1,1,{'dirt': 1}
Image__2023-03-17__13-27-30_label1_cls0,2,0,0,2,{'dirt': 2}
Image__2023-03-02__13-53-17_label3_cls0,2,0,2,0,{}
Image__2023-02-22__13-31-55_label0_cls0,2,0,1,1,{'dirt': 1}
Image__2023-02-22__14-06-55_label6_cls0,2,0,0,2,{'dirt': 2}
Image__2023-03-15__13-48-01_label0_cls0,2,0,1,1,{'dirt': 1}
Image__2023-03-10__13-20-47_label1_cls0,2,0,0,2,{'dirt': 2}
Image__2023-02-22__13-52-20_label0_cls0,2,0,1,1,{'dirt': 1}
Image__2023-03-06__13-56-33_label0_cls0,2,0,2,0,{}
Image__2023-03-10__13-20-47_label0_cls0,2,0,0,2,{'dirt': 2}
Image__2023-02-22__13-40-59_label0_cls0,2,0,0,2,{'dirt': 2}
Image__2023-03-10__13-58-21_label1_cls0,2,0,0,2,{'dirt': 2}
Image__2023-03-10__13-24-18_label0_cls0,2,0,0,2,{'dirt': 2}
Image__2023-03-14__14-00-19_label0_cls0,2,0,0,2,{'dirt': 2}
Image__2023-03-13__12-52-28_label0_cls0,2,0,1,1,{'dirt': 1}
Image__2023-02-28__14-11-51_label2_cls0,2,0,2,0,{}
Image__2023-02-28__14-19-45_label3_cls0,2,0,2,0,{}
Image__2024-03-26__13-30-46_label0_cls0,2,0,2,0,{}
Image__2023-02-22__14-06-55_label3_cls0,2,0,0,2,{'dirt': 2}
Image__2024-02-21__12-38-35_label0_cls0,2,0,2,0,{}
Image__2023-03-09__14-40-09_label0_cls0,2,0,0,2,{'dirt': 2}
Image__2024-01-30__13-12-00_label0_cls0,2,0,2,0,{}
Image__2023-02-22__14-06-55_label2_cls0,2,0,0,2,{'dirt': 2}
Image__2023-03-09__14-50-24_label0_cls0,2,0,2,0,{}
Image__2023-03-08__10-40-37_label0_cls0,2,0,1,1,{'dirt': 1}
Image__2023-03-14__14-24-34_label0_cls0,2,0,0,2,{'dirt': 2}
Image__2023-12-16__13-30-23_label7_cls0,2,0,2,0,{}
Image__2023-10-30__13-23-04_label0_cls0,2,0,0,2,{'dirt': 2}
Image__2023-03-08__10-34-25_label0_cls0,2,0,2,0,{}
Image__2023-03-17__13-21-17_label0_cls0,2,0,0,2,{'dirt': 2}
Image__2023-12-08__12-52-22_label0_cls0,2,0,2,0,{}
Image__2023-02-22__13-58-45_label0_cls0,2,0,1,1,{'dirt': 1}
Image__2023-12-16__13-30-23_label4_cls0,2,0,2,0,{}
Image__2023-03-02__14-15-58_label1_cls0,2,0,2,0,{}
Image__2023-03-13__13-07-35_label0_cls0,2,0,0,2,{'dirt': 2}
Image__2023-02-22__13-39-29_label1_cls0,2,0,1,1,{'dirt': 1}
Image__2023-02-22__13-40-59_label2_cls0,2,0,0,2,{'dirt': 2}
Image__2023-03-13__12-38-07_label0_cls0,2,0,1,1,{'dirt': 1}
Image__2024-01-29__13-12-22_label1_cls0,2,0,2,0,{}
Image__2023-02-22__13-40-59_label3_cls0,2,0,0,2,{'dirt': 2}
Image__2023-02-27__14-00-43_label0_cls0,2,0,1,1,{'dirt': 1}
Image__2023-03-02__13-35-35_label0_cls0,2,0,2,0,{}
Image__2023-03-17__13-11-28_label0_cls0,2,0,0,2,{'dirt': 2}
Image__2023-03-15__13-42-45_label0_cls0,2,0,0,2,{'dirt': 2}
Image__2023-03-14__14-08-05_label0_cls0,2,0,0,2,{'dirt': 2}
Image__2023-03-06__13-54-18_label1_cls0,2,0,2,0,{}
Image__2023-02-24__10-44-29_label0_cls0,2,0,0,2,{'dirt': 2}
Image__2023-03-02__13-53-17_label0_cls0,2,0,2,0,{}
Image__2024-03-26__13-28-27_label0_cls0,2,0,2,0,{}
Image__2023-03-01__13-38-12_label0_cls0,2,0,2,0,{}
Image__2023-02-28__13-55-28_label1_cls0,2,0,0,2,{'dirt': 2}
Image__2023-03-08__10-07-08_label0_cls0,2,0,0,2,{'dirt': 2}
Image__2023-02-27__13-47-10_label0_cls0,2,0,0,2,{'dirt': 2}
Image__2023-03-13__12-46-49_label0_cls0,2,0,1,1,{'dirt': 1}
Image__2023-03-02__13-50-07_label2_cls0,2,0,2,0,{}
Image__2023-02-28__14-00-57_label0_cls0,2,0,0,2,{'dirt': 2}
Image__2024-04-11__12-17-25_label0_cls0,2,0,2,0,{}
Image__2023-03-13__13-10-08_label0_cls0,2,0,1,1,{'dirt': 1}
Image__2023-03-17__12-50-33_label0_cls0,2,0,0,2,{'dirt': 2}
Image__2023-03-02__14-06-39_label0_cls0,2,0,0,2,{'dirt': 2}
Image__2023-02-23__14-19-31_label0_cls0,2,0,1,1,{'dirt': 1}
Image__2023-02-27__13-45-54_label6_cls0,2,0,1,1,{'dirt': 1}
Image__2023-03-10__13-21-29_label1_cls0,2,0,0,2,{'dirt': 2}
Image__2024-05-21__12-23-30_label0_cls0,2,0,2,0,{}
Image__2023-03-15__13-46-02_label2_cls0,2,0,0,2,{'dirt': 2}
Image__2023-03-13__12-42-21_label0_cls0,2,0,0,2,{'dirt': 2}
Image__2023-03-14__14-14-02_label1_cls0,2,0,0,2,{'dirt': 2}
Image__2023-12-16__13-42-01_label1_cls0,2,0,2,0,{}
Image__2023-03-06__14-09-52_label0_cls0,2,0,2,0,{}
Image__2023-03-17__13-23-33_label0_cls0,2,0,0,2,{'dirt': 2}
Image__2024-04-09__12-23-57_label0_cls0,2,0,2,0,{}
Image__2023-03-09__14-53-20_label0_cls0,2,0,1,1,{'dirt': 1}
Image__2024-02-21__12-37-08_label0_cls0,2,0,2,0,{}
Image__2023-02-24__10-40-02_label0_cls0,2,0,1,1,{'dirt': 1}
Image__2023-03-02__14-07-03_label0_cls0,2,0,0,2,{'dirt': 2}
Image__2023-03-10__13-26-56_label7_cls0,2,0,2,0,{}
Image__2024-05-14__12-19-19_label0_cls0,2,0,2,0,{}
Image__2023-10-30__13-18-44_label0_cls0,2,0,0,2,{'dirt': 2}
Image__2023-03-02__14-20-30_label0_cls0,2,0,2,0,{}
Image__2023-02-22__13-54-12_label1_cls0,2,0,0,2,{'dirt': 2}
Image__2023-02-28__13-59-21_label0_cls0,2,0,1,1,{'dirt': 1}
Image__2023-01-30__15-22-40_label0_cls0,2,0,0,2,{'dirt': 2}
Image__2023-03-10__12-51-31_label0_cls0,2,0,2,0,{}
Image__2023-03-17__13-05-47_label1_cls0,2,0,0,2,{'dirt': 2}
Image__2023-03-02__13-53-17_label1_cls0,2,0,2,0,{}
Image__2023-03-02__14-06-01_label0_cls0,2,0,1,1,{'dirt': 1}
Image__2023-03-14__14-24-34_label1_cls0,2,0,0,2,{'dirt': 2}
Image__2023-03-10__13-23-40_label0_cls0,2,0,0,2,{'dirt': 2}
Image__2023-02-23__14-27-36_label0_cls0,2,0,1,1,{'dirt': 1}
Image__2024-04-09__12-14-41_label0_cls0,2,0,2,0,{}
Image__2023-02-27__13-56-27_label0_cls0,2,0,1,1,{'dirt': 1}
Image__2023-03-08__10-10-46_label0_cls0,2,0,0,2,{'dirt': 2}
Image__2023-03-06__14-09-09_label0_cls0,2,0,2,0,{}
Image__2023-02-22__14-06-55_label4_cls0,2,0,0,2,{'dirt': 2}
Image__2024-03-14__12-24-49_label0_cls0,2,0,2,0,{}
Image__2023-12-16__13-32-44_label1_cls0,2,0,2,0,{}
Image__2024-01-22__12-09-32_label0_cls0,2,0,2,0,{}
Image__2023-02-07__14-38-28_label10_cls0,2,0,0,2,{'dirt': 2}
Image__2023-03-14__14-26-22_label1_cls0,2,0,0,2,{'dirt': 2}
Image__2024-05-21__12-21-46_label0_cls0,2,0,2,0,{}
Image__2024-02-21__12-36-38_label0_cls0,2,0,2,0,{}
Image__2024-04-15__12-15-23_label0_cls0,2,0,2,0,{}
Image__2023-03-10__13-40-26_label0_cls0,2,0,0,2,{'dirt': 2}
Image__2023-01-30__15-23-19_label0_cls0,2,0,1,1,{'dirt': 1}
Image__2023-03-06__14-00-09_label0_cls0,2,0,2,0,{}
Image__2023-02-27__14-38-28_label0_cls0,2,0,1,1,{'dirt': 1}
Image__2024-05-18__13-18-42_label0_cls0,2,0,2,0,{}
Image__2024-01-09__13-20-04_label0_cls0,2,0,2,0,{}
Image__2023-12-27__13-10-40_label4_cls0,2,0,2,0,{}
Image__2023-02-22__13-54-12_label0_cls0,2,0,0,2,{'dirt': 2}
Image__2023-02-27__14-11-51_label2_cls0,2,0,1,1,{'dirt': 1}
Image__2023-03-15__14-16-18_label0_cls0,2,0,0,2,{'dirt': 2}
Image__2023-02-28__14-19-45_label1_cls0,2,0,2,0,{}
Image__2023-03-14__14-09-19_label4_cls0,2,0,0,2,{'dirt': 2}
Image__2023-03-17__13-15-27_label0_cls0,2,0,0,2,{'dirt': 2}
Image__2024-04-15__12-15-47_label0_cls0,2,0,2,0,{}
Image__2023-02-23__14-11-48_label0_cls0,2,0,0,2,{'dirt': 2}
Image__2023-03-13__13-23-09_label2_cls0,2,0,0,2,{'dirt': 2}
Image__2024-03-28__13-30-55_label0_cls0,2,0,2,0,{}
Image__2023-03-14__14-22-59_label0_cls0,2,0,0,2,{'dirt': 2}
Image__2023-02-27__14-34-47_label0_cls0,2,0,1,1,{'dirt': 1}
Image__2023-03-08__10-10-46_label1_cls0,2,0,0,2,{'dirt': 2}
Image__2023-03-14__14-00-19_label1_cls0,2,0,0,2,{'dirt': 2}
Image__2023-03-10__13-58-21_label0_cls0,2,0,0,2,{'dirt': 2}
Image__2023-03-17__13-15-27_label1_cls0,2,0,0,2,{'dirt': 2}
Image__2023-03-16__13-39-24_label0_cls0,2,0,0,2,{'dirt': 2}
Image__2023-03-15__14-14-19_label1_cls0,2,0,0,2,{'dirt': 2}
Image__2023-03-10__13-11-54_label0_cls0,2,0,2,0,{}
Image__2023-02-27__14-23-36_label0_cls0,2,0,0,2,{'dirt': 2}
Image__2023-03-10__13-21-29_label0_cls0,2,0,0,2,{'dirt': 2}
Image__2023-02-28__13-55-28_label0_cls0,2,0,0,2,{'dirt': 2}
Image__2023-03-09__14-54-40_label0_cls0,2,0,1,1,{'dirt': 1}
Image__2023-03-17__13-23-33_label1_cls0,2,0,0,2,{'dirt': 2}
Image__2023-02-27__14-30-07_label0_cls0,2,0,0,2,{'dirt': 2}
Image__2023-03-13__13-28-06_label0_cls0,2,0,0,2,{'dirt': 2}
Image__2023-02-27__13-53-50_label0_cls0,2,0,0,2,{'dirt': 2}
Image__2023-02-22__14-06-55_label0_cls0,2,0,0,2,{'dirt': 2}
Image__2023-02-22__13-56-26_label1_cls0,2,0,1,1,{'dirt': 1}
Image__2023-12-16__13-32-44_label2_cls0,2,0,2,0,{}
Image__2023-03-15__14-13-39_label0_cls0,2,0,0,2,{'dirt': 2}
Image__2023-03-13__13-40-29_label0_cls0,2,0,1,1,{'dirt': 1}
Image__2023-02-22__13-57-29_label0_cls0,2,0,1,1,{'dirt': 1}
Image__2023-03-08__10-01-24_label1_cls0,2,0,1,1,{'dirt': 1}
Image__2023-03-08__10-01-59_label0_cls0,2,0,0,2,{'dirt': 2}
Image__2023-03-06__13-54-18_label0_cls0,2,0,2,0,{}
Image__2023-02-24__10-36-54_label0_cls0,2,0,1,1,{'dirt': 1}
Image__2023-02-06__15-20-35_label6_cls0,2,0,1,1,{'dirt': 1}
Image__2023-02-13__14-29-31_label1_cls0,2,0,1,1,{'dirt': 1}
Image__2024-04-10__12-16-22_label0_cls0,2,0,2,0,{}
Image__2023-02-28__13-52-33_label0_cls0,2,0,1,1,{'dirt': 1}
Image__2023-03-06__14-02-53_label0_cls0,2,0,2,0,{}
Image__2023-03-15__14-16-18_label1_cls0,2,0,0,2,{'dirt': 2}
Image__2023-03-01__13-54-22_label0_cls0,2,0,2,0,{}
Image__2023-05-24__13-02-43_label0_cls0,2,0,0,2,{'dirt': 2}
Image__2023-03-15__13-57-37_label0_cls0,2,0,1,1,{'dirt': 1}
Image__2023-03-13__13-10-47_label0_cls0,2,0,1,1,{'dirt': 1}
Image__2024-04-06__12-30-36_label0_cls0,2,0,2,0,{}
Image__2024-03-16__13-50-31_label0_cls0,2,0,2,0,{}
Image__2023-03-06__13-29-50_label0_cls0,2,0,2,0,{}
Image__2023-03-10__13-23-40_label1_cls0,2,0,0,2,{'dirt': 2}
Image__2023-02-28__14-19-45_label0_cls0,2,0,2,0,{}
Image__2023-03-14__14-08-05_label1_cls0,2,0,0,2,{'dirt': 2}
Image__2023-03-13__12-45-36_label0_cls0,2,0,1,1,{'dirt': 1}
Image__2023-02-23__14-11-48_label2_cls0,2,0,0,2,{'dirt': 2}
Image__2024-02-21__12-29-01_label0_cls0,2,0,2,0,{}
Image__2023-03-17__12-55-40_label0_cls0,2,0,0,2,{'dirt': 2}
Image__2023-03-15__14-26-50_label0_cls0,2,0,0,2,{'dirt': 2}
Image__2023-03-17__13-05-47_label2_cls0,2,0,0,2,{'dirt': 2}
Image__2024-05-16__12-15-38_label0_cls0,2,0,2,0,{}
Image__2023-03-14__14-23-27_label0_cls0,2,0,1,1,{'dirt': 1}
Image__2023-03-08__10-25-37_label0_cls0,1,0,1,0,{}
Image__2023-03-09__14-49-49_label0_cls0,1,0,1,0,{}
Image__2023-03-13__12-59-14_label0_cls0,1,0,0,1,{'dirt': 1}
Image__2023-02-22__13-49-42_label0_cls0,1,0,0,1,{'dirt': 1}
Image__2023-12-27__13-21-52_label0_cls0,1,0,1,0,{}
Image__2023-03-13__13-39-08_label0_cls0,1,0,0,1,{'dirt': 1}
Image__2023-02-24__10-30-52_label0_cls0,1,0,0,1,{'dirt': 1}
Image__2023-02-27__14-21-58_label0_cls0,1,0,0,1,{'dirt': 1}
Image__2023-03-13__13-16-12_label0_cls0,1,0,0,1,{'dirt': 1}
Image__2023-03-15__13-52-11_label0_cls0,1,0,0,1,{'dirt': 1}
Image__2023-02-27__14-32-32_label0_cls0,1,0,0,1,{'dirt': 1}
Image__2023-03-13__12-42-56_label0_cls0,1,0,0,1,{'dirt': 1}
Image__2023-03-14__13-57-33_label0_cls0,1,0,0,1,{'dirt': 1}
Image__2023-03-10__13-26-56_label1_cls0,1,0,1,0,{}
Image__2023-03-08__10-12-11_label3_cls0,1,0,1,0,{}
Image__2023-02-24__10-31-50_label0_cls0,1,0,0,1,{'dirt': 1}
Image__2023-03-08__10-26-40_label3_cls0,1,0,1,0,{}
Image__2023-03-17__12-58-04_label1_cls0,1,0,0,1,{'dirt': 1}
Image__2023-03-15__14-04-57_label0_cls0,1,0,0,1,{'dirt': 1}
Image__2023-01-30__15-33-10_label0_cls0,1,0,0,1,{'dirt': 1}
Image__2024-04-16__12-19-54_label0_cls0,1,0,1,0,{}
Image__2024-04-09__12-10-39_label0_cls0,1,0,1,0,{}
Image__2023-03-13__13-17-28_label0_cls0,1,0,0,1,{'dirt': 1}
Image__2023-03-15__13-33-07_label0_cls0,1,0,0,1,{'dirt': 1}
Image__2023-03-09__14-40-09_label1_cls0,1,0,0,1,{'dirt': 1}
Image__2023-03-15__13-27-30_label0_cls0,1,0,0,1,{'dirt': 1}
Image__2023-03-08__10-41-53_label0_cls0,1,0,0,1,{'dirt': 1}
Image__2023-03-16__13-51-14_label0_cls0,1,0,0,1,{'dirt': 1}
Image__2024-02-28__12-24-42_label0_cls0,1,0,1,0,{}
Image__2023-03-15__14-23-28_label0_cls0,1,0,0,1,{'dirt': 1}
Image__2023-03-17__13-20-39_label0_cls0,1,0,0,1,{'dirt': 1}
Image__2023-02-23__14-27-16_label0_cls0,1,0,0,1,{'dirt': 1}
Image__2023-03-16__13-44-33_label0_cls0,1,0,0,1,{'dirt': 1}
Image__2023-03-08__10-40-16_label0_cls0,1,0,0,1,{'dirt': 1}
Image__2023-12-27__13-12-59_label0_cls0,1,0,1,0,{}
Image__2023-02-22__13-57-29_label1_cls0,1,0,0,1,{'dirt': 1}
Image__2023-03-14__13-58-18_label0_cls0,1,0,0,1,{'dirt': 1}
Image__2023-03-15__13-32-29_label0_cls0,1,0,0,1,{'dirt': 1}
Image__2024-04-15__12-19-21_label0_cls0,1,0,1,0,{}
Image__2023-03-14__14-21-38_label0_cls0,1,0,0,1,{'dirt': 1}
Image__2023-03-09__14-44-37_label0_cls0,1,0,0,1,{'dirt': 1}
Image__2023-02-22__13-58-45_label1_cls0,1,0,0,1,{'dirt': 1}
Image__2023-02-22__14-03-56_label0_cls0,1,0,0,1,{'dirt': 1}
Image__2023-02-27__14-39-00_label1_cls0,1,0,0,1,{'dirt': 1}
Image__2023-03-08__10-01-24_label4_cls0,1,0,0,1,{'dirt': 1}
Image__2023-03-13__13-47-27_label0_cls0,1,0,0,1,{'dirt': 1}
Image__2023-02-24__10-28-53_label0_cls0,1,0,0,1,{'dirt': 1}
Image__2023-02-27__14-39-55_label0_cls0,1,0,0,1,{'dirt': 1}
Image__2023-03-13__12-41-14_label0_cls0,1,0,0,1,{'dirt': 1}
Image__2023-03-13__13-18-44_label0_cls0,1,0,0,1,{'dirt': 1}
Image__2023-03-10__13-55-51_label0_cls0,1,0,0,1,{'dirt': 1}
Image__2023-02-27__14-00-06_label1_cls0,1,0,0,1,{'dirt': 1}
Image__2024-01-29__13-07-16_label0_cls0,1,0,1,0,{}
Image__2023-02-22__13-44-43_label0_cls0,1,0,0,1,{'dirt': 1}
Image__2023-03-02__14-04-36_label0_cls0,1,0,0,1,{'dirt': 1}
Image__2023-02-06__15-20-35_label8_cls0,1,0,0,1,{'dirt': 1}
Image__2023-02-22__13-48-46_label1_cls0,1,0,0,1,{'dirt': 1}
Image__2023-02-22__13-31-22_label3_cls0,1,0,0,1,{'dirt': 1}
Image__2023-03-17__13-09-15_label0_cls0,1,0,0,1,{'dirt': 1}
Image__2023-03-14__14-12-23_label0_cls0,1,0,0,1,{'dirt': 1}
Image__2023-03-13__13-35-15_label0_cls0,1,0,0,1,{'dirt': 1}
Image__2023-02-27__14-33-45_label0_cls0,1,0,0,1,{'dirt': 1}
Image__2023-02-27__14-34-10_label0_cls0,1,0,0,1,{'dirt': 1}
Image__2023-02-24__10-28-09_label1_cls0,1,0,0,1,{'dirt': 1}
Image__2023-03-09__14-55-53_label0_cls0,1,0,0,1,{'dirt': 1}
Image__2023-03-15__14-13-39_label1_cls0,1,0,0,1,{'dirt': 1}
Image__2023-02-28__13-58-03_label0_cls0,1,0,0,1,{'dirt': 1}
Image__2023-02-23__14-18-01_label0_cls0,1,0,0,1,{'dirt': 1}
Image__2023-02-06__15-22-15_label0_cls0,1,0,0,1,{'dirt': 1}
Image__2023-02-28__13-43-54_label0_cls0,1,0,0,1,{'dirt': 1}
Image__2023-03-09__14-41-46_label0_cls0,1,0,0,1,{'dirt': 1}
Image__2023-03-15__14-15-04_label0_cls0,1,0,0,1,{'dirt': 1}
Image__2024-04-11__12-30-13_label0_cls0,1,0,1,0,{}
Image__2023-03-13__13-42-56_label0_cls0,1,0,0,1,{'dirt': 1}
Image__2023-03-02__14-00-07_label1_cls0,1,0,0,1,{'dirt': 1}
Image__2023-03-09__14-43-08_label0_cls0,1,0,0,1,{'dirt': 1}
Image__2023-02-22__13-43-10_label3_cls0,1,0,0,1,{'dirt': 1}
Image__2023-02-23__14-22-32_label0_cls0,1,0,0,1,{'dirt': 1}
Image__2023-03-08__10-01-24_label2_cls0,1,0,0,1,{'dirt': 1}
Image__2023-03-01__13-27-47_label4_cls0,1,0,1,0,{}
Image__2023-02-22__13-43-10_label2_cls0,1,0,0,1,{'dirt': 1}
Image__2023-02-22__14-10-50_label0_cls0,1,0,0,1,{'dirt': 1}
Image__2023-03-17__12-58-04_label0_cls0,1,0,0,1,{'dirt': 1}
Image__2023-03-10__14-00-15_label0_cls0,1,0,0,1,{'dirt': 1}
Image__2023-02-28__13-53-29_label1_cls0,1,0,0,1,{'dirt': 1}
Image__2023-02-27__14-02-08_label0_cls0,1,0,0,1,{'dirt': 1}
Image__2023-03-13__13-29-31_label0_cls0,1,0,0,1,{'dirt': 1}
Image__2023-03-10__13-49-15_label0_cls0,1,0,0,1,{'dirt': 1}
Image__2023-02-22__13-56-26_label6_cls0,1,0,0,1,{'dirt': 1}
Image__2023-03-10__13-22-21_label0_cls0,1,0,0,1,{'dirt': 1}
Image__2023-03-13__13-23-09_label3_cls0,1,0,0,1,{'dirt': 1}
Image__2023-03-09__14-45-19_label0_cls0,1,0,0,1,{'dirt': 1}
Image__2023-02-27__14-00-06_label2_cls0,1,0,0,1,{'dirt': 1}
Image__2023-05-24__13-03-49_label0_cls0,1,0,0,1,{'dirt': 1}
Image__2023-02-27__14-20-59_label1_cls0,1,0,0,1,{'dirt': 1}
Image__2023-02-06__15-22-15_label1_cls0,1,0,0,1,{'dirt': 1}
Image__2023-03-08__10-01-24_label3_cls0,1,0,0,1,{'dirt': 1}
Image__2023-03-15__14-12-35_label0_cls0,1,0,0,1,{'dirt': 1}
Image__2023-02-22__13-31-22_label4_cls0,1,0,0,1,{'dirt': 1}
Image__2023-02-22__13-37-45_label2_cls0,1,0,0,1,{'dirt': 1}
Image__2024-01-29__13-12-22_label2_cls0,1,0,1,0,{}
Image__2023-03-14__14-10-30_label0_cls0,1,0,0,1,{'dirt': 1}
Image__2023-03-10__13-26-56_label0_cls0,1,0,1,0,{}
Image__2023-02-27__14-29-06_label0_cls0,1,0,0,1,{'dirt': 1}
Image__2023-02-28__14-27-28_label0_cls0,1,0,0,1,{'dirt': 1}
Image__2023-02-28__13-49-00_label0_cls0,1,0,0,1,{'dirt': 1}
Image__2023-12-16__13-30-23_label14_cls0,1,0,1,0,{}
Image__2023-03-10__12-56-01_label0_cls0,1,0,1,0,{}
Image__2023-03-17__13-01-18_label0_cls0,1,0,0,1,{'dirt': 1}
Image__2023-02-27__13-45-54_label5_cls0,1,0,0,1,{'dirt': 1}
Image__2023-02-28__13-56-49_label1_cls0,1,0,0,1,{'dirt': 1}
Image__2023-03-08__10-04-07_label0_cls0,1,0,0,1,{'dirt': 1}
Image__2023-05-24__12-35-46_label0_cls0,1,0,0,1,{'dirt': 1}
Image__2023-03-16__13-43-13_label0_cls0,1,0,0,1,{'dirt': 1}
Image__2023-02-27__13-49-39_label0_cls0,1,0,0,1,{'dirt': 1}
Image__2023-03-13__12-38-57_label0_cls0,1,0,0,1,{'dirt': 1}
Image__2023-03-10__13-59-37_label0_cls0,1,0,0,1,{'dirt': 1}
Image__2023-05-24__12-43-23_label0_cls0,1,0,0,1,{'dirt': 1}
Image__2023-02-22__13-43-10_label1_cls0,1,0,0,1,{'dirt': 1}
Image__2023-03-15__14-14-19_label0_cls0,1,0,0,1,{'dirt': 1}
Image__2023-03-10__13-46-39_label0_cls0,1,0,0,1,{'dirt': 1}
Image__2023-03-08__10-12-11_label2_cls0,1,0,1,0,{}
Image__2023-02-27__14-28-38_label0_cls0,1,0,0,1,{'dirt': 1}
Image__2023-03-14__14-11-52_label0_cls0,1,0,0,1,{'dirt': 1}
Image__2023-03-13__12-38-57_label1_cls0,1,0,0,1,{'dirt': 1}
Image__2023-03-06__13-54-18_label2_cls0,1,0,1,0,{}
Image__2023-05-24__13-04-43_label0_cls0,1,0,0,1,{'dirt': 1}
Image__2023-02-02__13-50-01_label0_cls0,1,0,0,1,{'dirt': 1}
Image__2023-03-06__13-34-36_label0_cls0,1,0,1,0,{}
Image__2023-02-22__13-48-46_label0_cls0,1,0,0,1,{'dirt': 1}
Image__2023-03-13__13-21-33_label0_cls0,1,0,0,1,{'dirt': 1}
Image__2024-05-21__12-19-49_label0_cls0,1,0,1,0,{}
Image__2023-03-08__10-36-56_label1_cls0,1,0,0,1,{'dirt': 1}
Image__2023-03-06__13-47-55_label0_cls0,1,0,1,0,{}
Image__2023-02-24__10-32-21_label1_cls0,1,0,0,1,{'dirt': 1}
Image__2023-02-22__13-45-37_label0_cls0,1,0,0,1,{'dirt': 1}
Image__2023-03-06__13-40-49_label4_cls0,1,0,1,0,{}
Image__2023-03-08__10-43-11_label0_cls0,1,0,0,1,{'dirt': 1}
Image__2023-03-15__13-50-14_label0_cls0,1,0,0,1,{'dirt': 1}
Image__2024-04-25__13-19-29_label0_cls0,1,0,1,0,{}
Image__2023-03-10__13-54-41_label0_cls0,1,0,0,1,{'dirt': 1}
Image__2023-03-02__14-17-43_label0_cls0,1,0,1,0,{}
Image__2023-02-28__14-11-26_label0_cls0,1,0,1,0,{}
Image__2023-02-07__14-38-28_label1_cls0,1,0,0,1,{'dirt': 1}
Image__2023-02-27__13-56-03_label0_cls0,1,0,0,1,{'dirt': 1}
Image__2023-02-07__14-41-03_label0_cls0,1,0,0,1,{'dirt': 1}
Image__2023-02-23__14-16-45_label0_cls0,1,0,0,1,{'dirt': 1}
Image__2023-03-13__13-26-14_label0_cls0,1,0,0,1,{'dirt': 1}
Image__2024-05-16__12-31-16_label0_cls0,1,0,1,0,{}
Image__2023-02-22__13-40-33_label0_cls0,1,0,0,1,{'dirt': 1}
Image__2023-02-24__10-39-20_label0_cls0,1,0,0,1,{'dirt': 1}
Image__2023-03-16__14-03-06_label0_cls0,1,0,0,1,{'dirt': 1}
Image__2023-02-24__10-34-16_label0_cls0,1,0,0,1,{'dirt': 1}
Image__2023-02-24__10-41-27_label0_cls0,1,0,0,1,{'dirt': 1}
Image__2023-03-10__13-37-03_label0_cls0,1,0,0,1,{'dirt': 1}
Image__2023-02-27__14-39-00_label0_cls0,1,0,0,1,{'dirt': 1}
Image__2023-02-01__15-22-53_label0_cls0,1,0,0,1,{'dirt': 1}
Image__2023-02-27__14-40-52_label1_cls0,1,0,0,1,{'dirt': 1}
Image__2023-03-17__13-17-39_label0_cls0,1,0,0,1,{'dirt': 1}
Image__2023-05-24__12-52-34_label0_cls0,1,0,0,1,{'dirt': 1}
Image__2023-12-26__12-49-19_label0_cls0,1,0,1,0,{}
Image__2023-03-10__12-56-44_label0_cls0,1,0,1,0,{}
Image__2023-03-16__13-48-51_label0_cls0,1,0,0,1,{'dirt': 1}
Image__2023-02-28__13-56-49_label0_cls0,1,0,0,1,{'dirt': 1}
Image__2023-03-17__13-00-17_label0_cls0,1,0,0,1,{'dirt': 1}
Image__2023-02-07__14-38-28_label0_cls0,1,0,0,1,{'dirt': 1}
Image__2023-02-28__14-19-45_label4_cls0,1,0,1,0,{}
Image__2023-03-13__13-04-10_label1_cls0,1,0,0,1,{'dirt': 1}
Image__2023-03-02__14-30-13_label0_cls0,1,0,1,0,{}
Image__2023-03-17__13-13-48_label0_cls0,1,0,0,1,{'dirt': 1}
Image__2023-03-15__14-00-56_label0_cls0,1,0,0,1,{'dirt': 1}
Image__2023-03-14__14-22-09_label0_cls0,1,0,0,1,{'dirt': 1}
Image__2023-03-14__14-01-24_label0_cls0,1,0,0,1,{'dirt': 1}
Image__2023-03-17__13-24-53_label0_cls0,1,0,0,1,{'dirt': 1}
Image__2023-03-13__13-34-39_label1_cls0,1,0,0,1,{'dirt': 1}
Image__2023-03-13__12-46-12_label0_cls0,1,0,0,1,{'dirt': 1}
Image__2023-03-13__13-15-37_label0_cls0,1,0,0,1,{'dirt': 1}
Image__2024-03-14__12-33-35_label0_cls0,1,0,1,0,{}
Image__2024-04-16__12-14-13_label0_cls0,1,0,1,0,{}
Image__2023-02-22__13-38-13_label0_cls0,1,0,0,1,{'dirt': 1}
Image__2023-03-15__13-39-49_label0_cls0,1,0,0,1,{'dirt': 1}
Image__2023-03-17__13-17-01_label0_cls0,1,0,0,1,{'dirt': 1}
Image__2023-03-10__13-13-36_label0_cls0,1,0,1,0,{}
Image__2023-02-27__13-49-39_label2_cls0,1,0,0,1,{'dirt': 1}
Image__2023-03-08__10-01-24_label0_cls0,1,0,0,1,{'dirt': 1}
Image__2023-03-15__13-58-30_label0_cls0,1,0,0,1,{'dirt': 1}
Image__2023-03-17__13-05-04_label1_cls0,1,0,0,1,{'dirt': 1}
Image__2023-03-10__13-26-56_label2_cls0,1,0,1,0,{}
Image__2023-03-08__10-34-57_label0_cls0,1,0,1,0,{}
Image__2023-02-27__14-07-59_label0_cls0,1,0,0,1,{'dirt': 1}
Image__2023-02-22__13-45-37_label2_cls0,1,0,0,1,{'dirt': 1}
Image__2023-02-24__10-29-28_label0_cls0,1,0,0,1,{'dirt': 1}
Image__2023-03-10__13-23-00_label0_cls0,1,0,0,1,{'dirt': 1}
Image__2023-01-30__15-21-33_label0_cls0,1,0,0,1,{'dirt': 1}
Image__2023-03-02__14-19-14_label0_cls0,1,0,1,0,{}
Image__2023-03-10__13-31-01_label0_cls0,1,0,1,0,{}
Image__2023-03-13__13-41-13_label0_cls0,1,0,0,1,{'dirt': 1}
Image__2023-03-13__12-43-41_label0_cls0,1,0,0,1,{'dirt': 1}
Image__2023-02-23__14-33-42_label0_cls0,1,0,0,1,{'dirt': 1}
Image__2023-03-17__13-03-49_label0_cls0,1,0,0,1,{'dirt': 1}
Image__2023-01-30__15-33-50_label0_cls0,1,0,0,1,{'dirt': 1}
Image__2023-03-17__13-19-13_label0_cls0,1,0,0,1,{'dirt': 1}
Image__2023-03-15__14-28-44_label0_cls0,1,0,0,1,{'dirt': 1}
Image__2023-03-10__13-21-29_label2_cls0,1,0,0,1,{'dirt': 1}
Image__2023-03-15__14-18-39_label0_cls0,1,0,0,1,{'dirt': 1}
Image__2023-03-08__10-06-35_label0_cls0,1,0,0,1,{'dirt': 1}
Image__2023-03-13__12-33-54_label0_cls0,1,0,0,1,{'dirt': 1}
Image__2023-03-15__13-43-58_label0_cls0,1,0,0,1,{'dirt': 1}
Image__2023-02-24__10-29-28_label2_cls0,1,0,0,1,{'dirt': 1}
Image__2024-05-21__12-22-37_label0_cls0,1,0,1,0,{}
Image__2023-03-13__13-08-11_label0_cls0,1,0,0,1,{'dirt': 1}
Image__2023-03-13__13-34-39_label0_cls0,1,0,0,1,{'dirt': 1}
Image__2023-02-06__15-20-35_label7_cls0,1,0,0,1,{'dirt': 1}
Image__2023-03-02__14-00-07_label0_cls0,1,0,0,1,{'dirt': 1}
Image__2023-03-06__14-09-52_label1_cls0,1,0,1,0,{}
Image__2023-03-17__13-14-38_label0_cls0,1,0,0,1,{'dirt': 1}
Image__2023-02-23__14-21-23_label0_cls0,1,0,0,1,{'dirt': 1}
Image__2023-03-15__13-35-39_label0_cls0,1,0,0,1,{'dirt': 1}
Image__2023-03-17__13-14-38_label1_cls0,1,0,0,1,{'dirt': 1}
Image__2023-03-17__13-09-15_label1_cls0,1,0,0,1,{'dirt': 1}
Image__2023-05-24__12-26-32_label0_cls0,1,0,0,1,{'dirt': 1}
Image__2023-03-17__13-22-56_label0_cls0,1,0,0,1,{'dirt': 1}
Image__2023-03-09__14-52-04_label0_cls0,1,0,0,1,{'dirt': 1}
Image__2023-03-08__10-10-19_label0_cls0,1,0,0,1,{'dirt': 1}
Image__2023-03-08__10-35-30_label0_cls0,1,0,1,0,{}
Image__2023-02-22__13-47-34_label0_cls0,1,0,0,1,{'dirt': 1}
Image__2023-03-10__13-26-21_label0_cls0,1,0,0,1,{'dirt': 1}
Image__2023-02-27__14-00-06_label0_cls0,1,0,0,1,{'dirt': 1}
Image__2023-03-10__13-42-10_label0_cls0,1,0,0,1,{'dirt': 1}
Image__2023-03-08__10-01-24_label5_cls0,1,0,0,1,{'dirt': 1}
Image__2023-02-27__13-46-42_label0_cls0,1,0,0,1,{'dirt': 1}
Image__2023-03-02__13-50-07_label1_cls0,1,0,1,0,{}
Image__2023-03-17__12-56-53_label0_cls0,1,0,0,1,{'dirt': 1}
Image__2024-02-26__12-38-49_label0_cls0,1,0,1,0,{}
Image__2023-03-15__14-19-47_label0_cls0,1,0,0,1,{'dirt': 1}
Image__2023-03-14__14-25-06_label0_cls0,1,0,0,1,{'dirt': 1}
Image__2023-03-13__13-08-56_label0_cls0,1,0,0,1,{'dirt': 1}
Image__2023-02-22__13-37-45_label0_cls0,1,0,0,1,{'dirt': 1}
Image__2023-02-27__14-29-37_label0_cls0,1,0,0,1,{'dirt': 1}
Image__2023-03-10__13-57-17_label0_cls0,1,0,0,1,{'dirt': 1}
Image__2023-02-27__14-19-27_label0_cls0,1,0,0,1,{'dirt': 1}
Image__2023-02-22__13-43-10_label0_cls0,1,0,0,1,{'dirt': 1}
Image__2023-02-27__13-55-36_label0_cls0,1,0,0,1,{'dirt': 1}
Image__2023-02-22__13-55-48_label0_cls0,1,0,0,1,{'dirt': 1}
Image__2023-03-15__14-29-25_label0_cls0,1,0,0,1,{'dirt': 1}
Image__2023-10-30__13-22-09_label0_cls0,1,0,0,1,{'dirt': 1}
Image__2023-02-23__14-16-19_label0_cls0,1,0,0,1,{'dirt': 1}
Image__2023-03-06__13-22-47_label0_cls0,1,0,1,0,{}
Image__2023-03-15__13-43-25_label0_cls0,1,0,0,1,{'dirt': 1}
Image__2023-05-24__12-51-29_label0_cls0,1,0,0,1,{'dirt': 1}
Image__2023-03-15__13-46-02_label1_cls0,1,0,0,1,{'dirt': 1}
Image__2023-03-15__14-21-02_label0_cls0,1,0,0,1,{'dirt': 1}
Image__2023-03-13__13-03-34_label0_cls0,1,0,0,1,{'dirt': 1}
Image__2023-02-01__15-21-13_label0_cls0,1,0,0,1,{'dirt': 1}
Image__2023-03-17__13-24-17_label0_cls0,1,0,0,1,{'dirt': 1}
Image__2023-02-27__14-25-54_label0_cls0,1,0,0,1,{'dirt': 1}
Image__2023-02-23__14-29-47_label0_cls0,1,0,0,1,{'dirt': 1}
Image__2023-02-22__13-37-12_label0_cls0,1,0,0,1,{'dirt': 1}
Image__2023-02-28__13-56-49_label2_cls0,1,0,0,1,{'dirt': 1}
Image__2023-03-13__13-04-10_label0_cls0,1,0,0,1,{'dirt': 1}
Image__2024-04-06__12-41-49_label0_cls0,1,0,1,0,{}
Image__2023-03-14__14-26-22_label0_cls0,1,0,0,1,{'dirt': 1}
Image__2023-03-17__12-47-03_label0_cls0,1,0,0,1,{'dirt': 1}
Image__2023-03-01__13-27-47_label3_cls0,1,0,1,0,{}
Image__2023-03-02__14-02-12_label0_cls0,1,0,0,1,{'dirt': 1}
Image__2023-03-15__14-20-21_label0_cls0,1,0,0,1,{'dirt': 1}
Image__2023-02-27__14-29-06_label1_cls0,1,0,0,1,{'dirt': 1}
Image__2023-03-01__13-27-47_label1_cls0,1,0,1,0,{}
Image__2023-02-24__10-32-21_label0_cls0,1,0,0,1,{'dirt': 1}
Image__2024-04-25__13-14-08_label0_cls0,1,0,1,0,{}
Image__2023-03-06__13-36-36_label0_cls0,1,0,1,0,{}
Image__2023-02-27__14-07-59_label1_cls0,1,0,0,1,{'dirt': 1}
Image__2023-03-15__13-47-19_label0_cls0,1,0,0,1,{'dirt': 1}
Image__2023-02-27__14-29-06_label2_cls0,1,0,0,1,{'dirt': 1}
Image__2024-04-10__12-27-36_label0_cls0,1,0,1,0,{}
Image__2023-02-22__13-43-10_label4_cls0,1,0,0,1,{'dirt': 1}
Image__2024-04-03__13-26-35_label0_cls0,1,0,1,0,{}
Image__2023-03-10__12-54-31_label0_cls0,1,0,1,0,{}
Image__2023-03-02__14-03-34_label0_cls0,1,0,0,1,{'dirt': 1}
Image__2023-12-16__13-30-23_label8_cls0,1,0,1,0,{}
Image__2023-02-27__13-45-54_label3_cls0,1,0,0,1,{'dirt': 1}
Image__2023-03-13__13-18-06_label0_cls0,1,0,0,1,{'dirt': 1}
Image__2023-03-08__10-42-49_label0_cls0,1,0,0,1,{'dirt': 1}
Image__2023-02-22__13-27-48_label1_cls0,1,0,0,1,{'dirt': 1}
Image__2023-03-16__13-41-43_label0_cls0,1,0,0,1,{'dirt': 1}
Image__2023-02-27__13-50-45_label0_cls0,1,0,0,1,{'dirt': 1}
Image__2023-02-27__14-07-59_label2_cls0,1,0,0,1,{'dirt': 1}
Image__2023-02-22__13-27-48_label0_cls0,1,0,0,1,{'dirt': 1}
Image__2024-03-18__12-28-18_label0_cls0,1,0,1,0,{}
Image__2023-02-27__14-32-32_label1_cls0,1,0,0,1,{'dirt': 1}
Image__2023-03-17__13-10-45_label0_cls0,1,0,0,1,{'dirt': 1}
Image__2023-02-23__14-11-48_label3_cls0,1,0,0,1,{'dirt': 1}
Image__2023-03-01__13-31-49_label0_cls0,1,0,1,0,{}
Image__2023-03-09__14-55-24_label0_cls0,1,0,0,1,{'dirt': 1}
Image__2023-03-01__13-52-56_label0_cls0,1,0,1,0,{}
Image__2023-02-22__13-57-00_label0_cls0,1,0,0,1,{'dirt': 1}
Image__2023-12-11__12-26-31_label0_cls0,1,0,1,0,{}
Image__2023-02-27__13-45-54_label4_cls0,1,0,0,1,{'dirt': 1}
Image__2023-03-02__14-11-19_label0_cls0,1,0,1,0,{}
Image__2023-03-06__13-22-47_label1_cls0,1,0,1,0,{}
Image__2023-02-27__14-32-32_label3_cls0,1,0,0,1,{'dirt': 1}
Image__2023-03-17__13-13-48_label1_cls0,1,0,0,1,{'dirt': 1}
Image__2023-05-24__12-58-08_label0_cls0,1,0,0,1,{'dirt': 1}
Image__2023-03-15__13-40-57_label0_cls0,1,0,0,1,{'dirt': 1}
Image__2023-02-24__10-33-56_label0_cls0,1,0,0,1,{'dirt': 1}
Image__2023-02-28__13-49-38_label0_cls0,1,0,0,1,{'dirt': 1}
Image__2023-02-24__10-43-28_label1_cls0,1,0,0,1,{'dirt': 1}
Image__2023-03-13__13-04-52_label0_cls0,1,0,0,1,{'dirt': 1}
Image__2023-02-23__14-12-17_label0_cls0,1,0,0,1,{'dirt': 1}
Image__2023-02-22__13-39-29_label0_cls0,1,0,0,1,{'dirt': 1}
Image__2024-02-26__12-47-14_label0_cls0,1,0,1,0,{}
Image__2023-02-28__13-43-19_label0_cls0,1,0,0,1,{'dirt': 1}
Image__2023-10-30__13-29-21_label1_cls0,1,0,1,0,{}
Image__2023-03-13__13-03-00_label0_cls0,1,0,0,1,{'dirt': 1}
Image__2023-02-27__13-45-54_label1_cls0,1,0,0,1,{'dirt': 1}
Image__2023-03-17__12-53-33_label0_cls0,1,0,0,1,{'dirt': 1}
Image__2023-02-27__13-49-39_label1_cls0,1,0,0,1,{'dirt': 1}
Image__2023-03-14__14-20-45_label0_cls0,1,0,0,1,{'dirt': 1}
Image__2023-03-17__13-02-04_label0_cls0,1,0,0,1,{'dirt': 1}
Image__2023-03-13__13-50-07_label0_cls0,1,0,0,1,{'dirt': 1}
Image__2023-03-16__13-56-59_label0_cls0,1,0,0,1,{'dirt': 1}
Image__2023-03-13__12-34-34_label0_cls0,1,0,0,1,{'dirt': 1}
Image__2023-03-01__13-27-47_label0_cls0,1,0,1,0,{}
Image__2023-03-01__14-08-02_label0_cls0,1,0,1,0,{}
Image__2023-03-06__14-08-17_label0_cls0,1,0,1,0,{}
Image__2023-02-24__10-26-38_label0_cls0,1,0,0,1,{'dirt': 1}
Image__2023-02-27__14-32-32_label2_cls0,1,0,0,1,{'dirt': 1}
Image__2023-10-30__13-23-49_label0_cls0,1,0,0,1,{'dirt': 1}
Image__2023-03-10__13-26-56_label8_cls0,1,0,1,0,{}
Image__2023-02-27__14-39-31_label0_cls0,1,0,0,1,{'dirt': 1}
Image__2023-03-15__14-27-32_label0_cls0,1,0,0,1,{'dirt': 1}
Image__2023-02-27__14-26-27_label0_cls0,1,0,0,1,{'dirt': 1}
Image__2023-02-22__13-37-45_label1_cls0,1,0,0,1,{'dirt': 1}
Image__2023-03-13__13-45-26_label0_cls0,1,0,0,1,{'dirt': 1}
Image__2023-02-24__10-28-09_label0_cls0,1,0,0,1,{'dirt': 1}
Image__2023-03-15__13-28-55_label0_cls0,1,0,0,1,{'dirt': 1}
Image__2023-03-08__10-27-06_label0_cls0,1,0,1,0,{}
Image__2023-02-27__14-12-32_label0_cls0,1,0,0,1,{'dirt': 1}
Image__2023-03-06__14-03-46_label0_cls0,1,0,1,0,{}
Image__2023-02-22__13-41-30_label0_cls0,1,0,0,1,{'dirt': 1}
Image__2023-02-22__13-45-37_label1_cls0,1,0,0,1,{'dirt': 1}
Image__2023-03-17__13-08-41_label0_cls0,1,0,0,1,{'dirt': 1}
Image__2024-01-23__13-05-58_label0_cls0,1,0,1,0,{}
Image__2023-03-13__13-35-54_label0_cls0,1,0,0,1,{'dirt': 1}
Image__2023-03-14__14-25-51_label0_cls0,1,0,0,1,{'dirt': 1}
Image__2023-03-13__12-58-39_label0_cls0,1,0,0,1,{'dirt': 1}
Image__2023-02-27__14-35-59_label0_cls0,1,0,0,1,{'dirt': 1}
Image__2023-03-17__12-49-29_label0_cls0,1,0,0,1,{'dirt': 1}
Image__2023-03-13__13-04-10_label2_cls0,1,0,0,1,{'dirt': 1}
Image__2023-03-15__13-29-36_label0_cls0,1,0,0,1,{'dirt': 1}
Image__2023-03-13__12-56-46_label0_cls0,1,0,0,1,{'dirt': 1}
Image__2023-02-28__13-53-29_label0_cls0,1,0,0,1,{'dirt': 1}
Image__2023-03-02__14-07-32_label0_cls0,1,0,0,1,{'dirt': 1}
Image__2023-03-06__13-27-29_label0_cls0,1,0,1,0,{}
Image__2023-02-27__13-45-54_label2_cls0,1,0,0,1,{'dirt': 1}
Image__2023-03-13__12-39-45_label0_cls0,1,0,0,1,{'dirt': 1}
Image__2023-03-15__14-21-38_label0_cls0,1,0,0,1,{'dirt': 1}
Image__2023-12-16__13-30-23_label3_cls0,1,0,1,0,{}
Image__2024-04-11__12-25-09_label0_cls0,1,0,1,0,{}
Image__2023-03-08__10-06-09_label0_cls0,1,0,0,1,{'dirt': 1}
Image__2023-02-27__13-45-54_label0_cls0,1,0,0,1,{'dirt': 1}
Image__2023-02-22__13-36-39_label0_cls0,1,0,0,1,{'dirt': 1}
Image__2023-03-14__14-19-29_label0_cls0,1,0,0,1,{'dirt': 1}
Image__2023-03-17__13-05-04_label0_cls0,1,0,0,1,{'dirt': 1}
Image__2023-02-24__10-30-18_label0_cls0,1,0,0,1,{'dirt': 1}
Image__2023-03-15__13-34-23_label0_cls0,1,0,0,1,{'dirt': 1}
Image__2024-05-17__12-20-31_label0_cls0,1,0,1,0,{}
Image__2023-03-13__13-48-38_label0_cls0,1,0,0,1,{'dirt': 1}
Image__2023-03-08__10-04-29_label0_cls0,1,0,0,1,{'dirt': 1}
